player_name,age,g,gs,mp,fg,fga,fg_percent,x3p,x3pa,x3p_percent,x2p,x2pa,x2p_percent,e_fg_percent,ft,fta,ft_percent,orb,drb,trb,ast,stl,blk,tov,pf,pts,Pos,Tm
Alex Abrines,25,31,2,588,56,157,0.35668789808917195,41,127,0.3228346456692913,15,30,0.5,0.4872611464968153,12,13,0.9230769230769231,5,43,48,20,17,6,14,53,165,SG,OKC
Quincy Acy,28,10,0,123,4,18,0.2222222222222222,2,15,0.13333333333333333,2,3,0.6666666666666666,0.2777777777777778,7,10,0.7,3,22,25,8,1,4,4,24,17,PF,PHO
Jaylen Adams,22,34,1,428,38,110,0.34545454545454546,25,74,0.33783783783783783,13,36,0.3611111111111111,0.4590909090909091,7,9,0.7777777777777778,11,49,60,65,14,5,28,45,108,PG,ATL
Steven Adams,25,80,80,2669,481,809,0.5945611866501854,0,2,0,481,807,0.5960346964064436,0.5945611866501854,146,292,0.5,391,369,760,124,117,76,135,204,1108,C,OKC
Bam Adebayo,21,82,28,1913,280,486,0.5761316872427984,3,15,0.2,277,471,0.5881104033970276,0.5792181069958847,166,226,0.7345132743362832,165,432,597,184,71,65,121,203,729,C,MIA
Deng Adel,21,19,3,194,11,36,0.3055555555555556,6,23,0.2608695652173913,5,13,0.38461538461538464,0.3888888888888889,4,4,1,3,16,19,5,1,4,6,13,32,SF,CLE
DeVaughn Akoon-Purcell,25,7,0,22,3,10,0.3,0,4,0,3,6,0.5,0.3,1,2,0.5,1,3,4,6,2,0,2,4,7,SG,DEN
LaMarcus Aldridge,33,81,81,2687,684,1319,0.5185746777862017,10,42,0.23809523809523808,674,1277,0.5277995301487862,0.5223654283548143,349,412,0.8470873786407767,251,493,744,194,43,107,144,179,1727,C,SAS
Rawle Alkins,21,10,1,120,13,39,0.3333333333333333,3,12,0.25,10,27,0.37037037037037035,0.3717948717948718,8,12,0.6666666666666666,11,15,26,13,1,0,8,7,37,SG,CHI
Grayson Allen,23,38,2,416,67,178,0.37640449438202245,32,99,0.32323232323232326,35,79,0.4430379746835443,0.46629213483146065,45,60,0.75,3,20,23,25,6,6,33,47,211,SG,UTA
Jarrett Allen,20,80,80,2096,335,568,0.5897887323943662,6,45,0.13333333333333333,329,523,0.6290630975143403,0.5950704225352113,197,278,0.7086330935251799,191,481,672,110,43,120,103,184,873,C,BRK
Kadeem Allen,26,19,1,416,65,141,0.46099290780141844,17,36,0.4722222222222222,48,105,0.45714285714285713,0.5212765957446809,42,54,0.7777777777777778,8,43,51,76,16,4,26,46,189,SG,NYK
Al-Farouq Aminu,28,81,81,2292,257,593,0.433389544688027,96,280,0.34285714285714286,161,313,0.5143769968051118,0.5143338954468802,150,173,0.8670520231213873,112,498,610,104,68,33,72,143,760,PF,POR
Justin Anderson,25,48,4,463,64,157,0.40764331210191085,24,77,0.3116883116883117,40,80,0.5,0.4840764331210191,26,35,0.7428571428571429,24,60,84,23,22,13,23,48,178,SF,ATL
Kyle Anderson,25,43,40,1281,150,276,0.5434782608695652,9,34,0.2647058823529412,141,242,0.5826446280991735,0.5597826086956522,37,64,0.578125,48,203,251,128,54,37,58,112,346,SF,MEM
Ryan Anderson,30,50,16,644,42,138,0.30434782608695654,18,80,0.225,24,58,0.41379310344827586,0.3695652173913043,24,32,0.75,36,72,108,38,8,2,28,50,126,PF,TOT
Ike Anigbogu,20,3,0,6,0,3,0,0,0,0,0,3,0,0,0,0,0,1,2,3,1,0,1,1,0,0,C,IND
Giannis Antetokounmpo,24,72,72,2358,721,1247,0.5781876503608661,52,203,0.2561576354679803,669,1044,0.6408045977011494,0.599037690457097,500,686,0.7288629737609329,159,739,898,424,92,110,268,232,1994,PF,MIL
Kostas Antetokounmpo,21,2,0,11,0,3,0,0,0,0,0,3,0,0,2,4,0.5,0,1,1,0,2,0,1,0,2,PF,DAL
Carmelo Anthony,34,10,2,294,49,121,0.4049586776859504,21,64,0.328125,28,57,0.49122807017543857,0.49173553719008267,15,22,0.6818181818181818,9,45,54,5,4,7,8,32,134,PF,HOU
OG Anunoby,21,67,6,1352,183,404,0.452970297029703,67,202,0.3316831683168317,116,202,0.5742574257425742,0.5358910891089109,36,62,0.5806451612903226,58,139,197,47,46,22,55,140,469,SF,TOR
Ryan Arcidiacono,24,81,32,1961,187,418,0.4473684210526316,81,217,0.37327188940092165,106,201,0.527363184079602,0.5442583732057417,89,102,0.8725490196078431,27,192,219,269,65,4,63,171,544,PG,CHI
Trevor Ariza,33,138,138,4698,588,1472,0.39945652173913043,290,868,0.33410138248847926,298,604,0.49337748344370863,0.49796195652173914,260,328,0.7926829268292683,100,642,742,504,182,42,212,260,1726,SF,TOT
DJ Augustin,31,81,81,2269,318,677,0.46971935007385524,131,311,0.4212218649517685,187,366,0.5109289617486339,0.5664697193500738,181,209,0.8660287081339713,41,162,203,426,52,4,128,115,948,PG,ORL
Deandre Ayton,20,71,70,2183,509,870,0.5850574712643678,0,4,0,509,866,0.5877598152424942,0.5850574712643678,141,189,0.746031746031746,223,506,729,125,61,67,126,209,1159,C,PHO
Dwayne Bacon,23,43,13,759,122,257,0.47470817120622566,38,87,0.4367816091954023,84,170,0.49411764705882355,0.5486381322957199,34,46,0.7391304347826086,8,81,89,47,12,5,18,72,316,SG,CHO
Marvin Bagley,19,62,4,1567,356,706,0.5042492917847026,30,96,0.3125,326,610,0.5344262295081967,0.5254957507082153,181,262,0.6908396946564885,162,309,471,62,33,59,98,120,923,PF,SAC
Ron Baker,25,30,0,304,8,40,0.2,2,26,0.07692307692307693,6,14,0.42857142857142855,0.225,10,12,0.8333333333333334,2,20,22,30,12,2,10,36,28,SG,TOT
Wade Baldwin,22,16,0,94,10,33,0.30303030303030304,2,9,0.2222222222222222,8,24,0.3333333333333333,0.3333333333333333,8,11,0.7272727272727273,2,13,15,12,1,2,14,11,30,PG,POR
Lonzo Ball,21,47,45,1423,185,456,0.4057017543859649,75,228,0.32894736842105265,110,228,0.4824561403508772,0.48793859649122806,20,48,0.4166666666666667,54,197,251,255,69,19,103,114,465,PG,LAL
Mo Bamba,20,47,1,766,117,243,0.48148148148148145,21,70,0.3,96,173,0.5549132947976878,0.5246913580246914,37,63,0.5873015873015873,64,169,233,39,13,64,43,102,292,C,ORL
JJ Barea,34,38,0,752,161,385,0.41818181818181815,38,128,0.296875,123,257,0.4785992217898833,0.4675324675324675,55,78,0.7051282051282052,13,82,95,211,22,1,72,50,415,PG,DAL
Harrison Barnes,26,154,154,5066,862,2054,0.4196689386562804,348,882,0.3945578231292517,514,1172,0.43856655290102387,0.5043816942551119,458,556,0.8237410071942446,114,608,722,230,100,26,196,244,2530,PF,TOT
Will Barton,28,43,38,1189,185,460,0.40217391304347827,67,196,0.34183673469387754,118,264,0.44696969696969696,0.475,57,74,0.7702702702702703,32,167,199,124,18,22,65,82,494,SG,DEN
Keita Bates-Diop,23,30,3,503,60,142,0.4225352112676056,13,52,0.25,47,90,0.5222222222222223,0.46830985915492956,18,28,0.6428571428571429,16,67,83,17,18,14,14,29,151,SF,MIN
Nicolas Batum,30,75,72,2354,253,562,0.4501779359430605,116,298,0.38926174496644295,137,264,0.5189393939393939,0.5533807829181495,77,89,0.8651685393258427,71,319,390,247,71,43,117,140,699,SF,CHO
Jerryd Bayless,30,34,6,657,82,230,0.3565217391304348,29,98,0.29591836734693877,53,132,0.4015151515151515,0.41956521739130437,16,28,0.5714285714285714,11,51,62,119,18,2,32,56,209,PG,MIN
Aron Baynes,32,51,18,821,105,223,0.47085201793721976,21,61,0.3442622950819672,84,162,0.5185185185185185,0.5179372197309418,53,62,0.8548387096774194,88,152,240,57,12,34,40,125,284,C,BOS
Kent Bazemore,29,67,35,1643,278,691,0.402315484804631,96,300,0.32,182,391,0.46547314578005117,0.4717800289435601,127,175,0.7257142857142858,37,224,261,152,89,42,121,170,779,SG,ATL
Bradley Beal,25,82,82,3028,764,1609,0.4748290863890615,209,596,0.35067114093959734,555,1013,0.5478775913129319,0.5397762585456806,362,448,0.8080357142857143,89,322,411,448,121,58,224,226,2099,SG,WAS
Malik Beasley,22,81,18,1879,349,737,0.4735413839891452,163,405,0.4024691358024691,186,332,0.5602409638554217,0.5841248303934871,56,66,0.8484848484848485,35,165,200,97,55,10,55,116,917,SG,DEN
Michael Beasley,30,26,2,277,75,153,0.49019607843137253,3,17,0.17647058823529413,72,136,0.5294117647058824,0.5,28,39,0.717948717948718,13,47,60,25,9,10,27,42,181,PF,LAL
Marco Belinelli,32,79,1,1815,285,690,0.41304347826086957,147,395,0.3721518987341772,138,295,0.46779661016949153,0.5195652173913043,112,124,0.9032258064516129,16,182,198,132,35,8,72,121,829,SG,SAS
Jordan Bell,24,68,3,788,99,192,0.515625,0,2,0,99,190,0.5210526315789473,0.515625,25,41,0.6097560975609756,55,129,184,76,20,51,42,80,223,C,GSW
DeAndre' Bembry,24,82,15,1931,275,616,0.44642857142857145,50,173,0.28901734104046245,225,443,0.5079006772009029,0.487012987012987,87,136,0.6397058823529411,54,304,358,202,105,41,142,190,687,SG,ATL
Dragan Bender,21,46,27,826,88,197,0.4467005076142132,22,101,0.21782178217821782,66,96,0.6875,0.5025380710659898,32,54,0.5925925925925926,34,149,183,56,18,22,37,90,230,PF,PHO
Dairis Bertans,29,12,0,167,12,47,0.2553191489361702,10,34,0.29411764705882354,2,13,0.15384615384615385,0.3617021276595745,0,0,0,2,7,9,10,1,0,2,7,34,SG,NOP
Davis Bertans,26,76,12,1632,204,453,0.4503311258278146,145,338,0.4289940828402367,59,115,0.5130434782608696,0.6103752759381899,53,60,0.8833333333333333,23,241,264,100,35,33,43,133,606,PF,SAS
Patrick Beverley,30,78,49,2137,194,477,0.40670859538784065,112,282,0.3971631205673759,82,195,0.4205128205128205,0.5241090146750524,96,123,0.7804878048780488,76,312,388,300,67,43,85,265,596,PG,LAC
Khem Birch,26,50,1,643,91,151,0.6026490066225165,0,1,0,91,150,0.6066666666666667,0.6026490066225165,58,83,0.6987951807228916,79,111,190,38,18,29,20,72,240,C,ORL
Bismack Biyombo,26,54,32,783,89,156,0.5705128205128205,0,0,0,89,156,0.5705128205128205,0.5705128205128205,58,91,0.6373626373626373,81,166,247,33,11,41,34,103,236,C,CHO
Nemanja Bjelica,30,77,70,1788,284,593,0.47892074198988194,103,257,0.40077821011673154,181,336,0.5386904761904762,0.5657672849915683,70,92,0.7608695652173914,125,319,444,147,54,56,82,197,741,PF,SAC
Antonio Blakeney,22,57,3,829,166,396,0.41919191919191917,36,91,0.3956043956043956,130,305,0.4262295081967213,0.46464646464646464,50,76,0.6578947368421053,7,99,106,42,12,9,35,41,418,SG,CHI
Eric Bledsoe,29,78,78,2272,470,971,0.4840370751802266,124,377,0.32891246684350134,346,594,0.5824915824915825,0.5478887744593203,177,236,0.75,82,280,362,430,116,29,165,156,1241,PG,MIL
Jaron Blossomgame,25,27,4,439,47,106,0.44339622641509435,10,39,0.2564102564102564,37,67,0.5522388059701493,0.49056603773584906,10,13,0.7692307692307693,26,72,98,13,7,8,11,20,114,SF,CLE
Bogdan Bogdanovic,26,70,17,1947,361,863,0.4183082271147161,134,372,0.3602150537634409,227,491,0.4623217922606925,0.4959443800695249,134,162,0.8271604938271605,40,203,243,267,72,15,117,142,990,SG,SAC
Bojan Bogdanovic,29,81,81,2573,522,1051,0.4966698382492864,164,386,0.42487046632124353,358,665,0.5383458646616541,0.5746907706945766,246,305,0.8065573770491803,33,300,333,161,69,1,134,138,1454,SF,IND
Andrew Bogut,34,11,5,134,18,36,0.5,0,0,0,18,36,0.5,0.5,3,3,1,12,43,55,11,3,8,8,22,39,C,GSW
Jonah Bolden,23,44,10,639,80,162,0.49382716049382713,34,96,0.3541666666666667,46,66,0.696969696969697,0.5987654320987654,13,27,0.48148148148148145,47,118,165,40,17,39,36,99,207,PF,PHI
Isaac Bonga,19,22,0,120,5,33,0.15151515151515152,0,8,0,5,25,0.2,0.15151515151515152,9,15,0.6,9,16,25,15,9,4,6,9,19,PG,LAL
Devin Booker,22,64,64,2242,586,1255,0.46693227091633466,135,414,0.32608695652173914,451,841,0.5362663495838288,0.5207171314741036,393,454,0.8656387665198237,39,226,265,433,56,13,264,200,1700,SG,PHO
Chris Boucher,26,28,0,163,34,76,0.4473684210526316,12,37,0.32432432432432434,22,39,0.5641025641025641,0.5263157894736842,13,15,0.8666666666666667,16,40,56,2,6,24,7,31,93,PF,TOR
Avery Bradley,28,126,126,3810,496,1216,0.40789473684210525,172,490,0.3510204081632653,324,726,0.4462809917355372,0.4786184210526316,86,100,0.86,86,264,350,304,82,32,178,334,1250,SG,TOT
Tony Bradley,21,3,0,36,8,16,0.5,0,0,0,8,16,0.5,0.5,1,2,0.5,9,6,15,1,2,2,3,6,17,C,UTA
Corey Brewer,32,62,6,984,106,246,0.43089430894308944,28,88,0.3181818181818182,78,158,0.4936708860759494,0.4878048780487805,62,86,0.7209302325581395,52,100,152,78,64,14,38,126,302,SF,TOT
Mikal Bridges,22,82,56,2417,242,563,0.42984014209591476,105,313,0.3354632587859425,137,250,0.548,0.5230905861456483,95,118,0.8050847457627118,56,208,264,173,129,38,70,201,684,SF,PHO
Miles Bridges,20,80,25,1696,237,511,0.4637964774951076,65,200,0.325,172,311,0.5530546623794212,0.5273972602739726,58,77,0.7532467532467533,67,256,323,95,55,49,50,111,597,SF,CHO
Isaiah Briscoe,22,39,0,559,55,138,0.39855072463768115,11,34,0.3235294117647059,44,104,0.4230769230769231,0.4384057971014493,15,26,0.5769230769230769,5,69,74,87,11,2,31,66,136,PG,ORL
Ryan Broekhoff,28,42,0,453,57,126,0.4523809523809524,38,93,0.40860215053763443,19,33,0.5757575757575758,0.6031746031746031,15,19,0.7894736842105263,8,55,63,22,6,4,16,35,167,SG,DAL
Malcolm Brogdon,26,64,64,1832,378,748,0.5053475935828877,104,244,0.4262295081967213,274,504,0.5436507936507936,0.5748663101604278,141,152,0.9276315789473685,65,223,288,205,46,13,91,102,1001,SG,MIL
Dillon Brooks,23,18,0,330,49,122,0.4016393442622951,15,40,0.375,34,82,0.4146341463414634,0.46311475409836067,22,30,0.7333333333333333,9,22,31,16,10,4,19,50,135,SF,MEM
MarShon Brooks,30,29,0,387,76,169,0.44970414201183434,15,54,0.2777777777777778,61,115,0.5304347826086957,0.4940828402366864,23,33,0.696969696969697,12,33,45,25,9,4,21,33,190,SG,MEM
Bruce Brown,22,74,56,1449,125,314,0.3980891719745223,24,93,0.25806451612903225,101,221,0.45701357466063347,0.43630573248407645,45,60,0.75,48,137,185,91,40,36,46,178,319,SG,DET
Jaylen Brown,22,74,25,1913,368,792,0.46464646464646464,95,276,0.3442028985507246,273,516,0.5290697674418605,0.5246212121212122,133,202,0.6584158415841584,65,248,313,100,69,32,99,186,964,SG,BOS
Lorenzo Brown,28,26,0,212,23,71,0.323943661971831,6,28,0.21428571428571427,17,43,0.3953488372093023,0.36619718309859156,3,3,1,5,26,31,28,12,5,16,22,55,PG,TOR
Sterling Brown,23,58,7,1034,145,312,0.46474358974358976,53,147,0.36054421768707484,92,165,0.5575757575757576,0.5496794871794872,29,42,0.6904761904761905,29,155,184,84,25,8,46,88,372,SG,MIL
Troy Brown,19,52,10,730,97,234,0.41452991452991456,22,69,0.3188405797101449,75,165,0.45454545454545453,0.46153846153846156,32,47,0.6808510638297872,35,110,145,80,21,5,30,56,248,SF,WAS
Jalen Brunson,22,73,38,1591,264,565,0.4672566371681416,63,181,0.34806629834254144,201,384,0.5234375,0.5230088495575221,87,120,0.725,25,144,169,230,37,4,88,127,678,PG,DAL
Thomas Bryant,21,72,53,1496,309,502,0.6155378486055777,33,99,0.3333333333333333,276,403,0.684863523573201,0.648406374501992,107,137,0.781021897810219,113,341,454,92,25,67,60,126,758,C,WAS
Reggie Bullock,27,126,120,3758,490,1188,0.41245791245791247,296,786,0.37659033078880405,194,402,0.48258706467661694,0.5370370370370371,146,170,0.8588235294117647,44,302,346,258,80,24,130,218,1422,SG,TOT
Trey Burke,26,116,16,2250,472,1096,0.4306569343065693,112,318,0.3522012578616352,360,778,0.46272493573264784,0.48175182481751827,206,248,0.8306451612903226,56,142,198,318,66,14,98,116,1262,PG,TOT
Alec Burks,27,128,48,2750,384,948,0.4050632911392405,122,336,0.3630952380952381,262,612,0.42810457516339867,0.4694092827004219,232,282,0.8226950354609929,60,410,470,256,78,42,130,182,1122,SG,TOT
Deonte Burton,25,32,0,240,33,82,0.4024390243902439,8,27,0.2962962962962963,25,55,0.45454545454545453,0.45121951219512196,8,12,0.6666666666666666,4,24,28,9,6,8,9,31,82,SG,OKC
Jimmy Butler,29,130,130,4370,836,1808,0.46238938053097345,134,386,0.3471502590673575,702,1422,0.4936708860759494,0.49944690265486724,624,730,0.8547945205479452,242,442,684,526,246,78,190,222,2430,SF,TOT
Bruno Caboclo,23,34,19,800,96,225,0.4266666666666667,48,130,0.36923076923076925,48,95,0.5052631578947369,0.5333333333333333,42,50,0.84,42,116,158,50,14,33,38,81,282,SF,MEM
Jose Calderon,37,49,0,632,45,120,0.375,14,57,0.24561403508771928,31,63,0.49206349206349204,0.43333333333333335,9,11,0.8181818181818182,11,49,60,115,16,3,35,64,113,PG,DET
Kentavious Caldwell-Pope,25,82,23,2035,325,756,0.4298941798941799,151,435,0.3471264367816092,174,321,0.5420560747663551,0.5297619047619048,137,158,0.8670886075949367,48,190,238,110,73,13,65,137,938,SG,LAL
Isaiah Canaan,27,60,32,1258,128,328,0.3902439024390244,68,192,0.3541666666666667,60,136,0.4411764705882353,0.49390243902439024,38,48,0.7916666666666666,12,104,116,168,28,4,70,104,362,PG,TOT
Clint Capela,24,67,67,2249,474,732,0.6475409836065574,0,0,0,474,732,0.6475409836065574,0.6475409836065574,166,261,0.6360153256704981,298,550,848,96,44,102,94,168,1114,C,HOU
DeMarre Carroll,32,67,8,1703,227,575,0.3947826086956522,106,310,0.3419354838709677,121,265,0.45660377358490567,0.48695652173913045,184,242,0.7603305785123967,68,281,349,85,31,10,73,114,744,PF,BRK
Jevon Carter,23,39,3,577,56,185,0.3027027027027027,34,102,0.3333333333333333,22,83,0.26506024096385544,0.3945945945945946,26,32,0.8125,14,52,66,69,26,11,33,55,172,PG,MEM
Vince Carter,42,76,9,1330,196,468,0.4188034188034188,123,316,0.38924050632911394,73,152,0.48026315789473684,0.5502136752136753,47,66,0.7121212121212122,31,163,194,87,44,27,48,141,562,PF,ATL
Wendell Carter,19,44,44,1110,180,371,0.48517520215633425,6,32,0.1875,174,339,0.5132743362831859,0.49326145552560646,89,112,0.7946428571428571,87,220,307,78,26,58,65,152,455,C,CHI
Michael Carter-Williams,27,56,2,744,92,246,0.37398373983739835,20,76,0.2631578947368421,72,170,0.4235294117647059,0.4146341463414634,64,106,0.6037735849056604,38,102,140,140,40,30,40,96,268,PG,TOT
Alex Caruso,24,25,4,531,77,173,0.44508670520231214,24,50,0.48,53,123,0.43089430894308944,0.5144508670520231,51,64,0.796875,20,47,67,77,24,9,42,54,229,PG,LAL
Omri Casspi,30,36,0,520,86,161,0.5341614906832298,15,43,0.3488372093023256,71,118,0.6016949152542372,0.5807453416149069,39,58,0.6724137931034483,17,98,115,26,20,9,23,35,226,SF,MEM
Willie Cauley-Stein,25,81,81,2213,412,741,0.5560053981106613,1,2,0.5,411,739,0.5561569688768606,0.5566801619433198,140,254,0.5511811023622047,181,497,678,194,96,51,84,227,965,C,SAC
Troy Caupain,23,4,0,16,4,8,0.5,2,3,0.6666666666666666,2,5,0.4,0.625,0,0,0,1,2,3,4,1,0,0,0,10,PG,ORL
Tyler Cavanaugh,24,11,0,39,3,10,0.3,1,5,0.2,2,5,0.4,0.35,2,2,1,3,5,8,1,0,0,1,3,9,PF,UTA
Tyson Chandler,36,110,12,1750,122,198,0.6161616161616161,0,2,0,122,196,0.6224489795918368,0.6161616161616161,102,174,0.5862068965517241,184,430,614,74,42,46,84,220,346,C,TOT
Wilson Chandler,31,102,66,2354,228,546,0.4175824175824176,118,316,0.37341772151898733,110,230,0.4782608695652174,0.5256410256410257,36,50,0.72,96,334,430,164,50,42,92,246,610,PF,TOT
Joe Chealey,23,1,0,8,1,3,0.3333333333333333,0,0,0,1,3,0.3333333333333333,0.3333333333333333,0,0,0,0,0,0,1,0,0,0,1,2,PG,CHO
Chris Chiozza,23,7,0,33,2,8,0.25,2,5,0.4,0,3,0,0.375,0,0,0,1,3,4,4,1,1,1,2,6,PG,HOU
Marquese Chriss,21,86,4,998,134,360,0.37222222222222223,32,144,0.2222222222222222,102,216,0.4722222222222222,0.4166666666666667,64,90,0.7111111111111111,80,204,284,44,34,22,72,162,364,PF,TOT
Gary Clark,24,51,2,641,50,151,0.33112582781456956,41,138,0.2971014492753623,9,13,0.6923076923076923,0.46688741721854304,7,7,1,24,92,116,18,20,26,7,47,148,PF,HOU
Ian Clark,27,60,6,973,151,383,0.39425587467362927,66,202,0.32673267326732675,85,181,0.4696132596685083,0.4804177545691906,33,37,0.8918918918918919,13,76,89,94,22,8,58,95,401,SG,NOP
Jordan Clarkson,26,81,0,2214,529,1180,0.4483050847457627,144,445,0.3235955056179775,385,735,0.5238095238095238,0.5093220338983051,162,192,0.84375,82,188,270,196,57,13,135,112,1364,SG,CLE
John Collins,21,61,59,1829,465,831,0.5595667870036101,55,158,0.34810126582278483,410,673,0.6092124814264487,0.5926594464500602,203,266,0.7631578947368421,219,376,595,121,22,39,120,199,1188,PF,ATL
Zach Collins,21,77,0,1356,189,400,0.4725,40,121,0.3305785123966942,149,279,0.5340501792114696,0.5225,94,126,0.746031746031746,109,215,324,71,25,66,77,174,512,C,POR
Darren Collison,31,76,76,2143,308,659,0.4673748103186646,79,194,0.4072164948453608,229,465,0.4924731182795699,0.5273141122913505,158,190,0.8315789473684211,36,196,232,459,110,9,125,138,853,PG,IND
Bonzie Colson,23,8,2,98,13,39,0.3333333333333333,5,21,0.23809523809523808,8,18,0.4444444444444444,0.3974358974358974,8,9,0.8888888888888888,8,22,30,3,5,1,3,3,39,SF,MIL
Mike Conley,31,70,70,2342,490,1120,0.4375,155,426,0.36384976525821594,335,694,0.4827089337175792,0.5066964285714286,343,406,0.8448275862068966,40,199,239,449,94,22,130,123,1478,PG,MEM
Pat Connaughton,26,61,2,1261,163,350,0.4657142857142857,66,200,0.33,97,150,0.6466666666666666,0.56,29,40,0.725,61,197,258,122,33,25,33,81,421,SG,MIL
Quinn Cook,25,74,10,1059,204,439,0.4646924829157175,81,200,0.405,123,239,0.5146443514644351,0.5569476082004556,20,26,0.7692307692307693,22,135,157,116,20,3,50,92,509,PG,GSW
DeMarcus Cousins,28,30,30,771,178,371,0.4797843665768194,26,95,0.2736842105263158,152,276,0.5507246376811594,0.5148247978436657,106,144,0.7361111111111112,43,204,247,107,40,44,72,109,488,C,GSW
Robert Covington,28,70,70,2406,312,724,0.430939226519337,170,450,0.37777777777777777,142,274,0.5182481751824818,0.5483425414364641,136,178,0.7640449438202247,56,330,386,92,148,94,94,252,930,SF,TOT
Allen Crabbe,26,43,20,1133,137,373,0.3672922252010724,98,259,0.3783783783783784,39,114,0.34210526315789475,0.49865951742627346,41,56,0.7321428571428571,16,132,148,46,23,13,46,102,413,SG,BRK
Torrey Craig,28,75,37,1503,160,362,0.4419889502762431,61,188,0.324468085106383,99,174,0.5689655172413793,0.5262430939226519,49,70,0.7,89,174,263,72,37,46,44,175,430,SF,DEN
Jamal Crawford,38,64,0,1211,174,438,0.3972602739726027,67,202,0.3316831683168317,107,236,0.4533898305084746,0.4737442922374429,93,110,0.8454545454545455,8,77,85,229,33,12,99,75,508,SG,PHO
Mitch Creek,26,10,0,96,16,32,0.5,0,4,0,16,28,0.5714285714285714,0.5,10,14,0.7142857142857143,12,12,24,12,4,0,2,6,42,SF,TOT
Jae Crowder,28,80,11,2166,318,797,0.3989962358845671,173,522,0.3314176245210728,145,275,0.5272727272727272,0.5075282308657465,142,197,0.7208121827411168,60,324,384,133,64,31,85,170,951,SF,UTA
Dante Cunningham,31,64,21,928,75,158,0.47468354430379744,30,65,0.46153846153846156,45,93,0.4838709677419355,0.569620253164557,14,18,0.7777777777777778,48,140,188,50,27,13,22,71,194,PF,SAS
Seth Curry,28,74,2,1399,212,465,0.4559139784946237,113,251,0.450199203187251,99,214,0.46261682242990654,0.5774193548387097,44,52,0.8461538461538461,27,93,120,66,36,12,61,97,581,SG,POR
Stephen Curry,30,69,69,2331,632,1340,0.4716417910447761,354,810,0.43703703703703706,278,530,0.5245283018867924,0.6037313432835821,263,287,0.9163763066202091,45,324,369,361,92,25,192,166,1881,PG,GSW
Troy Daniels,27,51,1,760,113,275,0.4109090909090909,74,194,0.38144329896907214,39,81,0.48148148148148145,0.5454545454545454,18,23,0.782608695652174,13,60,73,26,26,5,27,79,318,SG,PHO
Anthony Davis,25,56,56,1850,530,1026,0.5165692007797271,48,145,0.3310344827586207,482,881,0.547105561861521,0.5399610136452242,344,433,0.7944572748267898,174,498,672,218,88,135,112,132,1452,C,NOP
Deyonta Davis,22,9,0,118,15,22,0.6818181818181818,0,1,0,15,21,0.7142857142857143,0.6818181818181818,6,10,0.6,10,26,36,5,3,5,3,12,36,C,ATL
Ed Davis,29,81,1,1446,186,302,0.6158940397350994,0,2,0,186,300,0.62,0.6158940397350994,100,162,0.6172839506172839,216,478,694,61,35,33,64,226,472,C,BRK
Tyler Davis,21,1,0,1,0,1,0,0,0,0,0,1,0,0,0,0,0,1,0,1,0,0,0,0,0,0,C,OKC
Dewayne Dedmon,29,64,52,1609,259,526,0.4923954372623574,83,217,0.3824884792626728,176,309,0.56957928802589,0.5712927756653993,92,113,0.8141592920353983,105,375,480,90,69,71,84,214,693,C,ATL
Sam Dekker,24,94,10,1576,240,512,0.46875,38,124,0.3064516129032258,202,388,0.520618556701031,0.505859375,56,92,0.6086956521739131,106,190,296,92,76,14,48,94,574,PF,TOT
Angel Delgado,24,2,0,15,1,5,0.2,0,0,0,1,5,0.2,0.2,1,2,0.5,2,2,4,0,1,0,0,2,3,C,LAC
Matthew Dellavedova,28,96,0,1624,196,484,0.4049586776859504,88,260,0.3384615384615385,108,224,0.48214285714285715,0.49586776859504134,84,104,0.8076923076923077,12,142,154,362,28,4,136,150,564,PG,TOT
Luol Deng,33,22,2,392,59,118,0.5,14,44,0.3181818181818182,45,74,0.6081081081081081,0.559322033898305,25,35,0.7142857142857143,20,53,73,18,15,8,14,24,157,SF,MIN
DeMar DeRozan,29,77,77,2688,631,1313,0.4805788271134806,7,45,0.15555555555555556,624,1268,0.4921135646687697,0.48324447829398326,366,441,0.8299319727891157,54,408,462,475,86,36,199,177,1635,SG,SAS
Marcus Derrickson,22,11,0,67,16,33,0.48484848484848486,10,20,0.5,6,13,0.46153846153846156,0.6363636363636364,4,5,0.8,8,5,13,1,0,1,3,9,46,PF,GSW
Cheick Diallo,22,64,1,896,168,271,0.6199261992619927,1,4,0.25,167,267,0.6254681647940075,0.6217712177121771,50,67,0.746268656716418,75,257,332,33,29,33,49,113,387,PF,NOP
Hamidou Diallo,20,51,3,526,75,165,0.45454545454545453,4,24,0.16666666666666666,71,141,0.5035460992907801,0.4666666666666667,36,59,0.6101694915254238,38,59,97,17,21,10,23,77,190,SG,OKC
Gorgui Dieng,29,76,2,1031,189,377,0.5013262599469496,19,56,0.3392857142857143,170,321,0.5295950155763239,0.5265251989389921,88,106,0.8301886792452831,81,230,311,72,48,41,57,134,485,C,MIN
Spencer Dinwiddie,25,68,4,1914,366,828,0.4420289855072464,124,370,0.33513513513513515,242,458,0.5283842794759825,0.5169082125603864,287,356,0.8061797752808989,26,140,166,311,40,17,152,187,1143,PG,BRK
Donte DiVincenzo,22,27,0,411,50,124,0.4032258064516129,22,83,0.26506024096385544,28,41,0.6829268292682927,0.49193548387096775,9,12,0.75,16,49,65,31,13,6,19,38,131,SG,MIL
Luka Doncic,19,72,72,2318,506,1186,0.4266441821247892,168,514,0.32684824902723736,338,672,0.5029761904761905,0.4974704890387858,346,485,0.7134020618556701,86,477,563,429,77,25,247,137,1526,SG,DAL
Tyler Dorsey,22,96,22,1396,214,528,0.4053030303030303,88,264,0.3333333333333333,126,264,0.4772727272727273,0.48863636363636365,76,122,0.6229508196721312,54,172,226,112,28,4,54,106,592,SG,TOT
Damyean Dotson,24,73,40,2004,290,698,0.4154727793696275,126,342,0.3684210526315789,164,356,0.4606741573033708,0.505730659025788,73,98,0.7448979591836735,34,228,262,135,58,10,71,135,779,SG,NYK
PJ Dozier,22,6,0,51,8,21,0.38095238095238093,2,8,0.25,6,13,0.46153846153846156,0.42857142857142855,1,2,0.5,6,11,17,5,2,0,0,2,19,SG,BOS
Goran Dragic,32,36,22,991,179,433,0.4133949191685912,57,164,0.3475609756097561,122,269,0.45353159851301117,0.4792147806004619,79,101,0.7821782178217822,20,91,111,174,30,5,71,81,494,PG,MIA
Andre Drummond,25,79,79,2647,561,1052,0.5332699619771863,5,38,0.13157894736842105,556,1014,0.5483234714003945,0.5356463878326996,243,412,0.5898058252427184,423,809,1232,112,136,138,175,272,1370,C,DET
Jared Dudley,33,59,25,1220,101,239,0.4225941422594142,53,151,0.3509933774834437,48,88,0.5454545454545454,0.5334728033472803,32,46,0.6956521739130435,34,121,155,83,36,16,43,131,287,PF,BRK
Kris Dunn,24,46,44,1389,215,506,0.424901185770751,34,96,0.3541666666666667,181,410,0.44146341463414634,0.45849802371541504,55,69,0.7971014492753623,19,168,187,277,68,21,104,166,519,PG,CHI
Kevin Durant,30,78,78,2702,721,1383,0.5213304410701374,137,388,0.35309278350515466,584,995,0.5869346733668341,0.5708604483007954,448,506,0.8853754940711462,33,464,497,457,58,84,225,155,2027,SF,GSW
Trevon Duval,20,3,0,6,2,3,0.6666666666666666,1,1,1,1,2,0.5,0.8333333333333334,0,0,0,0,1,1,2,0,0,0,0,5,PG,MIL
Vince Edwards,22,2,0,16,1,4,0.25,1,4,0.25,0,0,0,0.375,0,0,0,1,1,2,0,0,0,0,0,3,SF,HOU
Henry Ellenson,22,38,0,518,78,190,0.4105263157894737,34,76,0.4473684210526316,44,114,0.38596491228070173,0.5,38,50,0.76,10,122,132,32,14,4,18,54,228,PF,TOT
Wayne Ellington,31,106,76,2594,368,914,0.4026258205689278,276,744,0.3709677419354839,92,170,0.5411764705882353,0.5536105032822757,78,98,0.7959183673469388,28,186,214,144,108,12,80,184,1090,SG,TOT
Joel Embiid,24,64,64,2154,580,1199,0.4837364470391993,79,263,0.30038022813688214,501,936,0.5352564102564102,0.5166805671392828,522,649,0.8043143297380585,160,711,871,234,46,122,226,211,1761,C,PHI
James Ennis,28,116,54,2460,276,588,0.46938775510204084,110,312,0.3525641025641026,166,276,0.6014492753623188,0.5629251700680272,116,162,0.7160493827160493,120,244,364,82,82,46,68,300,778,SF,TOT
Drew Eubanks,21,23,0,113,15,26,0.5769230769230769,0,0,0,15,26,0.5769230769230769,0.5769230769230769,11,13,0.8461538461538461,6,28,34,7,2,5,8,11,41,PF,SAS
Jacob Evans,21,30,1,204,18,53,0.33962264150943394,4,15,0.26666666666666666,14,38,0.3684210526315789,0.37735849056603776,0,1,0,6,19,25,23,5,3,11,28,40,SG,GSW
Jawun Evans,22,16,0,130,6,28,0.21428571428571427,0,6,0,6,22,0.2727272727272727,0.21428571428571427,0,0,0,2,22,24,20,6,0,12,16,12,PG,TOT
Tyreke Evans,29,69,18,1402,257,660,0.3893939393939394,77,216,0.35648148148148145,180,444,0.40540540540540543,0.44772727272727275,115,160,0.71875,33,168,201,166,58,18,118,117,706,SG,IND
Dante Exum,23,42,1,664,101,241,0.4190871369294606,18,62,0.2903225806451613,83,179,0.46368715083798884,0.45643153526970953,68,86,0.7906976744186046,16,52,68,110,14,5,52,69,288,PG,UTA
Kenneth Faried,29,74,26,1456,312,530,0.5886792452830188,16,50,0.32,296,480,0.6166666666666667,0.6037735849056604,128,198,0.6464646464646465,194,306,500,40,34,46,66,164,768,C,TOT
Derrick Favors,27,76,70,1766,363,619,0.5864297253634895,17,78,0.21794871794871795,346,541,0.6395563770794824,0.6001615508885298,154,228,0.6754385964912281,207,353,560,89,56,106,84,163,897,C,UTA
Raymond Felton,34,33,0,379,55,135,0.4074074074074074,20,61,0.32786885245901637,35,74,0.47297297297297297,0.48148148148148145,12,13,0.9230769230769231,4,30,34,52,10,6,14,29,142,PG,OKC
Cristiano Felicio,26,60,0,746,95,179,0.5307262569832403,0,4,0,95,175,0.5428571428571428,0.5307262569832403,50,73,0.684931506849315,79,139,218,37,11,7,33,69,240,C,CHI
Terrance Ferguson,20,74,74,1931,185,431,0.42923433874709976,106,290,0.36551724137931035,79,141,0.5602836879432624,0.5522041763341067,37,51,0.7254901960784313,33,108,141,72,40,16,47,231,513,SG,OKC
Yogi Ferrell,25,71,3,1067,153,352,0.4346590909090909,54,149,0.3624161073825503,99,203,0.4876847290640394,0.5113636363636364,60,67,0.8955223880597015,13,96,109,137,36,4,40,64,420,PG,SAC
Dorian Finney-Smith,25,81,26,1985,228,528,0.4318181818181818,79,254,0.3110236220472441,149,274,0.5437956204379562,0.5066287878787878,73,103,0.7087378640776699,138,251,389,95,69,36,74,186,608,SF,DAL
Bryn Forbes,25,82,81,2293,361,791,0.4563843236409608,176,413,0.4261501210653753,185,378,0.4894179894179894,0.5676359039190898,69,78,0.8846153846153846,18,221,239,175,45,4,80,159,967,SG,SAS
Evan Fournier,26,81,81,2553,468,1069,0.43779232927970063,153,450,0.34,315,619,0.5088852988691438,0.509354536950421,137,170,0.8058823529411765,38,220,258,295,71,12,154,225,1226,SG,ORL
De'Aaron Fox,21,81,81,2546,505,1102,0.45825771324863884,86,232,0.3706896551724138,419,870,0.48160919540229885,0.49727767695099817,303,417,0.7266187050359713,43,261,304,590,133,45,227,204,1399,PG,SAC
Melvin Frazier,22,10,0,44,7,21,0.3333333333333333,0,6,0,7,15,0.4666666666666667,0.3333333333333333,1,4,0.25,3,2,5,1,1,0,1,6,15,SG,ORL
Tim Frazier,28,118,38,2240,232,522,0.4444444444444444,74,202,0.36633663366336633,158,320,0.49375,0.5153256704980843,82,108,0.7592592592592593,82,254,336,496,60,10,152,224,620,PG,TOT
Jimmer Fredette,29,6,0,65,8,29,0.27586206896551724,0,13,0,8,16,0.5,0.27586206896551724,6,6,1,1,6,7,8,3,0,5,5,22,SG,PHO
Channing Frye,35,36,6,341,43,117,0.36752136752136755,32,79,0.4050632911392405,11,38,0.2894736842105263,0.5042735042735043,11,14,0.7857142857142857,4,48,52,20,6,5,13,44,129,C,CLE
Markelle Fultz,20,19,15,427,65,155,0.41935483870967744,4,14,0.2857142857142857,61,141,0.4326241134751773,0.432258064516129,21,37,0.5675675675675675,26,44,70,59,17,5,25,52,155,SG,PHI
Danilo Gallinari,30,68,68,2059,409,884,0.4626696832579186,161,372,0.4327956989247312,248,512,0.484375,0.5537330316742082,367,406,0.9039408866995073,54,363,417,178,49,23,99,129,1346,SF,LAC
Langston Galloway,27,80,4,1745,228,587,0.38841567291311757,135,380,0.35526315789473684,93,207,0.4492753623188406,0.5034071550255537,81,96,0.84375,49,122,171,85,37,8,24,135,672,SG,DET
Billy Garrett,24,4,0,63,11,27,0.4074074074074074,0,8,0,11,19,0.5789473684210527,0.4074074074074074,4,4,1,0,3,3,7,1,1,2,3,26,SG,NYK
Marc Gasol,34,158,144,4872,780,1740,0.4482758620689655,198,546,0.3626373626373626,582,1194,0.48743718592964824,0.5051724137931034,384,506,0.758893280632411,160,1094,1254,698,168,172,310,434,2142,C,TOT
Pau Gasol,38,60,12,720,84,188,0.44680851063829785,12,26,0.46153846153846156,72,162,0.4444444444444444,0.4787234042553192,56,80,0.7,44,230,274,104,10,30,32,58,236,C,TOT
Rudy Gay,32,69,51,1842,376,746,0.5040214477211796,74,184,0.40217391304347827,302,562,0.5373665480427047,0.5536193029490617,120,147,0.8163265306122449,63,407,470,182,54,34,114,159,946,PF,SAS
Paul George,28,77,77,2841,707,1614,0.43804213135068154,292,757,0.3857331571994716,415,857,0.48424737456242706,0.5285006195786865,453,540,0.8388888888888889,105,523,628,318,170,34,205,214,2159,SF,OKC
Taj Gibson,33,70,57,1686,304,537,0.5661080074487895,11,34,0.3235294117647059,293,503,0.5825049701789264,0.5763500931098696,134,177,0.7570621468926554,172,286,458,84,53,39,73,186,753,PF,MIN
Harry Giles,20,58,0,820,175,348,0.5028735632183908,0,6,0,175,342,0.5116959064327485,0.5028735632183908,58,91,0.6373626373626373,66,156,222,85,31,22,73,150,408,PF,SAC
Shai Gilgeous-Alexander,20,82,73,2174,341,716,0.4762569832402235,51,139,0.3669064748201439,290,577,0.5025996533795494,0.5118715083798883,156,195,0.8,57,175,232,270,96,45,141,175,889,PG,LAC
Rudy Gobert,26,81,80,2577,476,712,0.6685393258426966,0,0,0,476,712,0.6685393258426966,0.6685393258426966,332,522,0.6360153256704981,309,732,1041,161,66,187,130,231,1284,C,UTA
Brandon Goodwin,23,16,0,57,6,23,0.2608695652173913,2,6,0.3333333333333333,4,17,0.23529411764705882,0.30434782608695654,9,11,0.8181818181818182,1,2,3,14,0,0,3,7,23,PG,DEN
Aaron Gordon,23,78,78,2633,470,1046,0.44933078393881454,121,347,0.34870317002881845,349,699,0.49928469241773965,0.5071701720841301,185,253,0.7312252964426877,129,445,574,289,57,56,162,172,1246,PF,ORL
Eric Gordon,30,68,53,2158,384,938,0.4093816631130064,216,600,0.36,168,338,0.4970414201183432,0.5245202558635395,119,152,0.7828947368421053,17,131,148,129,41,27,90,143,1103,SG,HOU
Marcin Gortat,34,47,43,751,99,186,0.532258064516129,0,0,0,99,186,0.532258064516129,0.532258064516129,35,48,0.7291666666666666,67,194,261,65,6,24,50,92,233,C,LAC
Devonte' Graham,23,46,3,676,74,216,0.3425925925925926,34,121,0.2809917355371901,40,95,0.42105263157894735,0.4212962962962963,35,46,0.7608695652173914,10,53,63,121,23,2,30,48,217,PG,CHO
Treveon Graham,25,35,21,715,64,191,0.33507853403141363,38,128,0.296875,26,63,0.4126984126984127,0.43455497382198954,18,22,0.8181818181818182,23,84,107,34,13,7,17,68,184,SG,BRK
Jerami Grant,24,80,77,2612,409,823,0.49696233292831105,115,293,0.3924914675767918,294,530,0.5547169811320755,0.5668286755771568,157,221,0.7104072398190046,96,321,417,79,61,100,67,214,1090,PF,OKC
Jerian Grant,26,60,1,939,92,220,0.41818181818181815,40,110,0.36363636363636365,52,110,0.4727272727272727,0.509090909090909,26,40,0.65,19,79,98,156,44,6,51,78,250,PG,ORL
Donte Grantham,23,3,0,2,0,2,0,0,2,0,0,0,0,0,0,0,0,0,0,0,0,0,0,0,0,0,SF,OKC
Danny Green,31,80,80,2216,293,630,0.4650793650793651,198,435,0.45517241379310347,95,195,0.48717948717948717,0.6222222222222222,37,44,0.8409090909090909,60,257,317,126,73,53,75,171,821,SG,TOR
Draymond Green,28,66,66,2065,188,422,0.44549763033175355,47,165,0.28484848484848485,141,257,0.5486381322957199,0.5011848341232228,63,91,0.6923076923076923,60,421,481,454,95,70,169,197,486,PF,GSW
Gerald Green,33,73,0,1473,231,578,0.39965397923875434,156,441,0.35374149659863946,75,137,0.5474452554744526,0.5346020761245674,57,68,0.8382352941176471,30,152,182,40,33,27,55,126,675,SG,HOU
JaMychal Green,28,130,12,2742,460,952,0.4831932773109244,142,352,0.4034090909090909,318,600,0.53,0.5577731092436975,160,202,0.7920792079207921,208,610,818,100,90,68,174,386,1222,PF,TOT
Jeff Green,32,77,44,2097,326,687,0.4745269286754003,111,320,0.346875,215,367,0.5858310626702997,0.5553129548762736,183,206,0.8883495145631068,57,252,309,137,43,39,101,160,946,PF,WAS
Blake Griffin,29,75,75,2622,619,1341,0.4615958240119314,189,522,0.3620689655172414,430,819,0.525030525030525,0.5320656226696495,414,550,0.7527272727272727,100,465,565,402,52,28,253,199,1841,PF,DET
Daniel Hamilton,23,19,3,204,23,60,0.38333333333333336,8,23,0.34782608695652173,15,37,0.40540540540540543,0.45,3,6,0.5,10,37,47,22,6,1,16,19,57,SG,ATL
Dusty Hannahs,25,2,0,26,3,12,0.25,0,5,0,3,7,0.42857142857142855,0.25,2,2,1,0,1,1,5,1,0,1,1,8,SG,MEM
Tim Hardaway,26,130,126,4114,780,1986,0.39274924471299094,324,954,0.33962264150943394,456,1032,0.4418604651162791,0.4743202416918429,464,552,0.8405797101449275,66,378,444,318,108,16,210,282,2348,SG,TOT
James Harden,29,78,78,2867,843,1909,0.4415924567836564,378,1028,0.36770428015564205,465,881,0.5278093076049943,0.5405971712938711,754,858,0.8787878787878788,66,452,518,586,158,58,387,244,2818,PG,HOU
Maurice Harkless,25,60,53,1415,189,388,0.48711340206185566,33,120,0.275,156,268,0.582089552238806,0.529639175257732,49,73,0.6712328767123288,77,192,269,74,67,53,45,163,460,SF,POR
Montrezl Harrell,25,82,5,2158,546,888,0.6148648648648649,3,17,0.17647058823529413,543,871,0.6234213547646383,0.6165540540540541,266,414,0.642512077294686,184,351,535,162,71,110,132,255,1361,C,LAC
Devin Harris,35,68,2,1071,132,347,0.3804034582132565,62,200,0.31,70,147,0.47619047619047616,0.4697406340057637,102,134,0.7611940298507462,12,100,112,122,35,16,56,133,428,PG,DAL
Gary Harris,24,57,48,1639,270,637,0.423861852433281,82,242,0.33884297520661155,188,395,0.4759493670886076,0.48822605965463106,115,144,0.7986111111111112,41,119,160,127,55,19,68,113,737,SG,DEN
Joe Harris,27,76,76,2293,374,748,0.5,183,386,0.4740932642487047,191,362,0.5276243093922652,0.6223262032085561,110,133,0.8270676691729323,52,239,291,181,38,17,121,182,1041,SG,BRK
Tobias Harris,26,164,164,5694,1222,2508,0.48724082934609253,312,786,0.3969465648854962,910,1722,0.5284552845528455,0.5494417862838915,532,614,0.8664495114006515,138,1152,1290,458,102,74,302,368,3288,PF,TOT
Andrew Harrison,24,34,0,374,32,106,0.3018867924528302,10,50,0.2,22,56,0.39285714285714285,0.3490566037735849,34,36,0.9444444444444444,12,28,40,48,8,4,24,68,108,PG,TOT
Shaquille Harrison,25,73,11,1430,184,426,0.431924882629108,24,89,0.2696629213483146,160,337,0.47477744807121663,0.460093896713615,82,123,0.6666666666666666,33,189,222,139,89,30,60,124,474,PG,CHI
Josh Hart,23,67,22,1715,189,464,0.4073275862068966,92,274,0.3357664233576642,97,190,0.5105263157894737,0.5064655172413793,55,80,0.6875,35,213,248,93,64,40,58,147,525,SG,LAL
Isaiah Hartenstein,20,28,0,221,20,41,0.4878048780487805,2,6,0.3333333333333333,18,35,0.5142857142857142,0.5121951219512195,11,14,0.7857142857142857,21,26,47,15,7,12,13,56,53,PF,HOU
Udonis Haslem,38,10,1,74,11,33,0.3333333333333333,0,12,0,11,21,0.5238095238095238,0.3333333333333333,3,4,0.75,3,24,27,2,0,0,3,9,25,C,MIA
Gordon Hayward,28,72,18,1863,296,635,0.46614173228346456,77,231,0.3333333333333333,219,404,0.5420792079207921,0.5267716535433071,156,187,0.8342245989304813,51,271,322,244,62,23,105,104,825,PF,BOS
John Henson,28,14,0,188,31,67,0.4626865671641791,11,31,0.3548387096774194,20,36,0.5555555555555556,0.5447761194029851,6,10,0.6,16,55,71,14,7,11,12,16,79,C,MIL
Juan Hernangomez,23,70,25,1358,138,314,0.4394904458598726,66,181,0.36464088397790057,72,133,0.5413533834586466,0.5445859872611465,66,86,0.7674418604651163,64,201,265,55,27,24,37,94,408,PF,DEN
Willy Hernangomez,24,58,3,812,153,295,0.5186440677966102,15,39,0.38461538461538464,138,256,0.5390625,0.5440677966101695,100,144,0.6944444444444444,117,194,311,60,16,20,58,98,421,C,CHO
Mario Hezonja,23,58,24,1206,191,464,0.41163793103448276,42,152,0.27631578947368424,149,312,0.4775641025641026,0.45689655172413796,87,114,0.7631578947368421,28,211,239,88,57,8,88,110,511,SF,NYK
Isaiah Hicks,24,3,0,32,4,8,0.5,0,0,0,4,8,0.5,0.5,4,5,0.8,2,5,7,2,1,3,1,5,12,PF,NYK
Buddy Hield,26,82,82,2615,623,1360,0.45808823529411763,278,651,0.4270353302611367,345,709,0.48660084626234135,0.5602941176470588,171,193,0.8860103626943006,106,306,412,205,58,33,146,202,1695,SG,SAC
Haywood Highsmith,22,5,0,40,4,10,0.4,1,5,0.2,3,5,0.6,0.45,0,2,0,0,5,5,2,1,0,1,1,9,SF,PHI
George Hill,32,120,26,2604,340,752,0.4521276595744681,96,306,0.3137254901960784,244,446,0.547085201793722,0.5159574468085106,140,170,0.8235294117647058,78,218,296,270,104,16,102,204,916,PG,TOT
Solomon Hill,27,44,15,878,68,178,0.38202247191011235,32,101,0.31683168316831684,36,77,0.4675324675324675,0.47191011235955055,23,32,0.71875,34,99,133,55,23,10,31,80,191,SF,NOP
Nene Hilario,36,42,2,546,60,116,0.5172413793103449,0,3,0,60,113,0.5309734513274337,0.5172413793103449,31,47,0.6595744680851063,34,89,123,26,18,15,11,87,151,C,HOU
Aaron Holiday,22,50,0,646,105,262,0.40076335877862596,43,127,0.33858267716535434,62,135,0.45925925925925926,0.48282442748091603,41,50,0.82,5,62,67,87,21,13,40,71,294,PG,IND
Jrue Holiday,28,67,67,2402,547,1159,0.4719585849870578,118,363,0.325068870523416,429,796,0.5389447236180904,0.5228645383951682,208,271,0.7675276752767528,75,259,334,518,109,54,210,148,1420,SG,NOP
Justin Holiday,29,164,154,5214,600,1554,0.3861003861003861,324,930,0.34838709677419355,276,624,0.4423076923076923,0.49034749034749037,190,212,0.8962264150943396,92,554,646,292,242,72,208,328,1714,SG,TOT
John Holland,30,1,0,1,0,0,0,0,0,0,0,0,0,0,0,0,0,0,0,0,0,0,0,0,0,0,SF,CLE
Rondae Hollis-Jefferson,24,59,21,1234,200,487,0.4106776180698152,9,49,0.1836734693877551,191,438,0.4360730593607306,0.419917864476386,118,183,0.644808743169399,83,227,310,96,44,27,68,107,527,SF,BRK
Richaun Holmes,25,70,4,1184,222,365,0.6082191780821918,0,0,0,222,365,0.6082191780821918,0.6082191780821918,128,175,0.7314285714285714,115,216,331,60,42,79,52,194,572,C,PHO
Rodney Hood,26,144,98,3786,584,1342,0.43517138599105815,168,472,0.3559322033898305,416,870,0.4781609195402299,0.4977645305514158,274,310,0.8838709677419355,50,264,314,252,118,24,110,292,1610,SG,TOT
Al Horford,32,68,68,1973,387,723,0.5352697095435685,73,203,0.35960591133004927,314,520,0.6038461538461538,0.5857538035961273,78,95,0.8210526315789474,120,338,458,283,59,86,102,126,925,C,BOS
Danuel House,25,39,13,979,118,252,0.46825396825396826,74,178,0.4157303370786517,44,74,0.5945945945945946,0.6150793650793651,56,71,0.7887323943661971,25,115,140,40,21,11,35,80,366,SF,HOU
Dwight Howard,33,9,9,230,43,69,0.6231884057971014,0,0,0,43,69,0.6231884057971014,0.6231884057971014,29,48,0.6041666666666666,24,59,83,4,7,4,16,34,115,C,WAS
Kevin Huerter,20,75,59,2048,275,657,0.4185692541856925,136,353,0.38526912181303113,139,304,0.45723684210526316,0.5220700152207002,41,56,0.7321428571428571,60,185,245,214,65,25,109,155,727,SG,ATL
Isaac Humphries,21,5,1,56,6,21,0.2857142857142857,3,11,0.2727272727272727,3,10,0.3,0.35714285714285715,0,0,0,4,7,11,0,1,0,0,7,15,C,ATL
RJ Hunter,25,1,0,26,6,13,0.46153846153846156,4,10,0.4,2,3,0.6666666666666666,0.6153846153846154,1,2,0.5,1,2,3,3,1,0,0,3,17,SG,BOS
Chandler Hutchison,22,44,14,895,96,209,0.45933014354066987,14,50,0.28,82,159,0.5157232704402516,0.49282296650717705,23,38,0.6052631578947368,31,154,185,34,23,6,25,59,229,SF,CHI
Serge Ibaka,29,74,51,2010,464,877,0.5290763968072976,49,169,0.28994082840236685,415,708,0.5861581920903954,0.557012542759407,135,177,0.7627118644067796,156,445,601,99,29,103,114,211,1112,C,TOR
Andre Iguodala,35,68,13,1578,151,302,0.5,48,144,0.3333333333333333,103,158,0.6518987341772152,0.5794701986754967,39,67,0.582089552238806,48,204,252,216,61,51,52,95,389,SF,GSW
Joe Ingles,31,82,82,2568,359,802,0.4476309226932668,189,483,0.391304347826087,170,319,0.5329153605015674,0.5654613466334164,87,123,0.7073170731707317,35,295,330,469,98,20,193,180,994,PF,UTA
Andre Ingram,33,4,0,15,0,6,0,0,3,0,0,3,0,0,0,0,0,1,1,2,0,1,0,1,0,0,SG,LAL
Brandon Ingram,21,52,52,1760,362,729,0.49657064471879286,31,94,0.32978723404255317,331,635,0.521259842519685,0.5178326474622771,195,289,0.6747404844290658,41,226,267,154,28,31,129,149,950,SF,LAL
Kyrie Irving,26,67,67,2214,604,1241,0.48670427074939565,174,434,0.4009216589861751,430,807,0.5328376703841388,0.556809024979855,214,245,0.8734693877551021,71,264,335,464,103,34,172,167,1596,PG,BOS
Jonathan Isaac,21,75,64,1996,262,611,0.4288052373158756,86,266,0.3233082706766917,176,345,0.5101449275362319,0.49918166939443537,110,135,0.8148148148148148,99,312,411,80,59,98,75,143,720,PF,ORL
Wesley Iwundu,24,68,13,1233,113,274,0.4124087591240876,29,79,0.3670886075949367,84,195,0.4307692307692308,0.4653284671532847,84,103,0.8155339805825242,37,147,184,73,28,22,44,123,339,SF,ORL
Ersan Ilyasova,31,67,7,1231,167,381,0.43832020997375326,58,160,0.3625,109,221,0.49321266968325794,0.5144356955380578,61,74,0.8243243243243243,94,208,302,52,32,20,48,172,453,PF,MIL
Demetrius Jackson,24,6,0,39,8,15,0.5333333333333333,2,6,0.3333333333333333,6,9,0.6666666666666666,0.6,4,4,1,2,1,3,5,2,0,1,4,22,PG,PHI
Frank Jackson,20,61,16,1169,194,447,0.43400447427293065,53,169,0.3136094674556213,141,278,0.5071942446043165,0.49328859060402686,54,73,0.7397260273972602,25,109,134,69,25,2,48,92,495,PG,NOP
Jaren Jackson,19,58,56,1515,298,589,0.5059422750424448,51,142,0.3591549295774648,247,447,0.5525727069351231,0.5492359932088285,151,197,0.766497461928934,73,199,272,64,52,82,98,220,798,PF,MEM
Josh Jackson,21,79,29,1988,347,841,0.4126040428061831,73,225,0.3244444444444444,274,616,0.4448051948051948,0.45600475624256837,143,213,0.6713615023474179,66,281,347,183,74,56,173,209,910,SG,PHO
Justin Jackson,23,162,28,3228,434,970,0.44742268041237115,174,490,0.3551020408163265,260,480,0.5416666666666666,0.5371134020618556,124,158,0.7848101265822784,88,336,424,192,64,28,58,198,1166,SF,TOT
Reggie Jackson,28,82,82,2289,441,1047,0.42120343839541546,174,471,0.36942675159235666,267,576,0.4635416666666667,0.504297994269341,204,236,0.864406779661017,45,171,216,344,55,9,148,208,1260,PG,DET
LeBron James,34,55,55,1937,558,1095,0.5095890410958904,111,327,0.3394495412844037,447,768,0.58203125,0.5602739726027397,278,418,0.6650717703349283,57,408,465,454,72,33,197,94,1505,SF,LAL
Amile Jefferson,25,12,0,68,10,16,0.625,0,0,0,10,16,0.625,0.625,7,8,0.875,6,15,21,3,3,3,1,8,27,PF,ORL
John Jenkins,27,52,0,666,84,210,0.4,44,116,0.3793103448275862,40,94,0.425531914893617,0.5047619047619047,30,36,0.8333333333333334,12,62,74,44,0,4,18,20,242,SG,TOT
Jonas Jerebko,31,73,6,1218,163,355,0.4591549295774648,69,188,0.3670212765957447,94,167,0.562874251497006,0.5563380281690141,64,80,0.8,72,216,288,96,27,18,43,137,459,PF,GSW
Alize Johnson,22,14,0,64,4,16,0.25,1,2,0.5,3,14,0.21428571428571427,0.28125,4,8,0.5,4,15,19,1,1,3,0,7,13,PF,IND
Amir Johnson,31,51,6,529,79,157,0.5031847133757962,12,40,0.3,67,117,0.5726495726495726,0.5414012738853503,31,41,0.7560975609756098,47,100,147,60,16,13,45,99,201,C,PHI
BJ Johnson,23,14,0,98,18,36,0.5,6,14,0.42857142857142855,12,22,0.5454545454545454,0.5833333333333334,4,4,1,4,12,16,0,4,0,4,8,46,SF,TOT
James Johnson,31,55,33,1164,164,379,0.43271767810026385,50,149,0.33557046979865773,114,230,0.4956521739130435,0.49868073878627966,50,70,0.7142857142857143,22,154,176,135,35,27,74,114,428,PF,MIA
Stanley Johnson,22,132,14,2416,342,880,0.3886363636363636,124,430,0.28837209302325584,218,450,0.48444444444444446,0.4590909090909091,100,128,0.78125,68,366,434,176,120,28,162,228,908,SF,TOT
Tyler Johnson,26,114,44,3058,434,1052,0.41254752851711024,180,520,0.34615384615384615,254,532,0.4774436090225564,0.49809885931558934,190,254,0.7480314960629921,68,278,346,332,108,54,154,194,1238,PG,TOT
Wesley Johnson,31,76,26,1068,90,256,0.3515625,50,152,0.32894736842105265,40,104,0.38461538461538464,0.44921875,26,38,0.6842105263157895,24,120,144,46,28,24,36,126,256,SF,TOT
Nikola Jokic,23,80,80,2504,616,1206,0.5107794361525705,83,270,0.3074074074074074,533,936,0.5694444444444444,0.5451907131011609,289,352,0.8210227272727273,228,637,865,580,108,55,248,228,1604,C,DEN
Damian Jones,23,24,22,410,53,74,0.7162162162162162,0,0,0,53,74,0.7162162162162162,0.7162162162162162,24,37,0.6486486486486487,31,44,75,28,12,25,16,63,130,C,GSW
Derrick Jones,21,60,14,1153,160,324,0.49382716049382713,28,91,0.3076923076923077,132,233,0.5665236051502146,0.5370370370370371,74,122,0.6065573770491803,96,144,240,37,46,42,43,123,422,SF,MIA
Jalen Jones,25,16,0,214,26,62,0.41935483870967744,10,28,0.35714285714285715,16,34,0.47058823529411764,0.5,19,27,0.7037037037037037,11,23,34,7,9,2,8,27,81,SF,CLE
Jemerrio Jones,23,6,2,143,12,33,0.36363636363636365,2,10,0.2,10,23,0.43478260869565216,0.3939393939393939,1,2,0.5,16,33,49,13,7,5,5,10,27,SF,LAL
Terrence Jones,27,2,0,5,1,4,0.25,0,2,0,1,2,0.5,0.25,0,1,0,0,4,4,0,0,0,1,1,2,PF,HOU
Tyus Jones,22,68,23,1560,185,446,0.4147982062780269,40,126,0.31746031746031744,145,320,0.453125,0.45964125560538116,58,69,0.8405797101449275,23,111,134,327,81,5,47,78,468,PG,MIN
DeAndre Jordan,30,138,138,4094,572,892,0.6412556053811659,0,0,0,572,892,0.6412556053811659,0.6412556053811659,372,528,0.7045454545454546,450,1354,1804,312,84,146,306,334,1516,C,TOT
Cory Joseph,27,82,9,2063,226,548,0.4124087591240876,55,171,0.3216374269005848,171,377,0.4535809018567639,0.4625912408759124,30,43,0.6976744186046512,39,240,279,321,94,22,80,131,537,PG,IND
Frank Kaminsky,25,47,0,755,138,298,0.46308724832214765,50,139,0.3597122302158273,88,159,0.5534591194968553,0.5469798657718121,79,107,0.7383177570093458,39,124,163,63,12,12,41,68,405,C,CHO
Enes Kanter,26,134,62,3280,750,1366,0.5490483162518301,20,68,0.29411764705882354,730,1298,0.5624036979969184,0.5563689604685212,310,394,0.7868020304568528,514,804,1318,232,64,52,236,334,1830,C,TOT
Luke Kennard,22,63,10,1437,228,520,0.43846153846153846,106,269,0.3940520446096654,122,251,0.4860557768924303,0.5403846153846154,51,61,0.8360655737704918,12,171,183,114,26,10,57,92,613,SG,DET
Michael Kidd-Gilchrist,25,64,3,1179,158,332,0.4759036144578313,16,47,0.3404255319148936,142,285,0.4982456140350877,0.5,95,123,0.7723577235772358,88,158,246,61,32,39,43,156,427,PF,CHO
George King,25,1,0,6,0,0,0,0,0,0,0,0,0,0,0,0,0,0,1,1,0,0,0,0,0,0,SF,PHO
Maxi Kleber,27,71,18,1502,175,386,0.4533678756476684,77,218,0.3532110091743119,98,168,0.5833333333333334,0.5531088082901554,58,74,0.7837837837837838,90,239,329,70,36,78,54,143,485,PF,DAL
Brandon Knight,27,78,52,1472,198,520,0.38076923076923075,82,258,0.3178294573643411,116,262,0.44274809160305345,0.4596153846153846,54,68,0.7941176470588235,20,98,118,142,42,4,60,124,532,PG,TOT
Kevin Knox,19,75,57,2158,338,914,0.36980306345733044,125,364,0.3434065934065934,213,550,0.38727272727272727,0.43818380743982493,162,226,0.7168141592920354,61,274,335,82,43,24,114,175,963,PF,NYK
Furkan Korkmaz,21,48,7,679,98,245,0.4,47,144,0.3263888888888889,51,101,0.504950495049505,0.4959183673469388,36,44,0.8181818181818182,16,91,107,52,29,2,25,62,279,SG,PHI
Luke Kornet,23,46,18,784,107,283,0.37809187279151946,70,193,0.3626943005181347,37,90,0.4111111111111111,0.5017667844522968,38,46,0.8260869565217391,28,107,135,54,27,42,25,41,322,PF,NYK
Kyle Korver,37,140,0,2668,402,966,0.4161490683229814,276,696,0.39655172413793105,126,270,0.4666666666666667,0.5590062111801242,120,146,0.821917808219178,18,306,324,162,50,24,118,212,1200,SG,TOT
Kosta Koufos,29,42,1,502,73,153,0.477124183006536,0,0,0,73,153,0.477124183006536,0.477124183006536,10,24,0.4166666666666667,52,125,177,36,15,18,27,68,156,C,SAC
Rodions Kurucs,20,63,46,1294,202,449,0.44988864142538976,58,184,0.31521739130434784,144,265,0.5433962264150943,0.5144766146993318,72,92,0.782608695652174,56,190,246,52,41,25,77,146,534,SF,BRK
Kyle Kuzma,23,70,68,2314,496,1087,0.4563017479300828,128,422,0.3033175355450237,368,665,0.5533834586466165,0.515179392824287,188,250,0.752,60,322,382,178,41,26,133,170,1308,PF,LAL
Skal Labissiere,22,44,2,352,52,98,0.5306122448979592,12,26,0.46153846153846156,40,72,0.5555555555555556,0.5918367346938775,18,34,0.5294117647058824,18,68,86,22,10,12,22,58,134,PF,TOT
Jeremy Lamb,26,79,55,2250,431,979,0.4402451481103167,115,330,0.3484848484848485,316,649,0.4869029275808937,0.4989785495403473,231,260,0.8884615384615384,65,369,434,172,88,32,80,140,1208,SG,CHO
Zach LaVine,23,63,62,2171,530,1135,0.4669603524229075,120,321,0.37383177570093457,410,814,0.5036855036855037,0.5198237885462555,312,375,0.832,40,254,294,283,60,26,215,140,1492,SG,CHI
Jake Layman,24,71,33,1327,216,424,0.5094339622641509,59,181,0.3259668508287293,157,243,0.6460905349794238,0.5790094339622641,50,71,0.704225352112676,56,161,217,53,31,30,46,116,541,SF,POR
TJ Leaf,21,58,1,522,99,183,0.5409836065573771,8,31,0.25806451612903225,91,152,0.5986842105263158,0.5628415300546448,19,31,0.6129032258064516,43,82,125,24,9,19,12,35,225,PF,IND
Courtney Lee,33,68,12,856,106,258,0.4108527131782946,32,110,0.2909090909090909,74,148,0.5,0.4728682170542636,28,42,0.6666666666666666,18,90,108,74,42,6,28,64,272,SG,TOT
Damion Lee,26,32,0,375,56,127,0.4409448818897638,27,68,0.39705882352941174,29,59,0.4915254237288136,0.547244094488189,19,22,0.8636363636363636,8,56,64,13,13,0,11,28,158,SG,GSW
Walt Lemon,26,6,3,167,38,87,0.4367816091954023,2,5,0.4,36,82,0.43902439024390244,0.4482758620689655,8,11,0.7272727272727273,4,23,27,30,11,1,10,14,86,PG,CHI
Alex Len,25,77,31,1544,320,648,0.49382716049382713,74,204,0.3627450980392157,246,444,0.5540540540540541,0.5509259259259259,140,216,0.6481481481481481,158,266,424,86,27,69,97,200,854,C,ATL
Kawhi Leonard,27,60,60,2040,560,1129,0.49601417183348095,112,302,0.3708609271523179,448,827,0.5417170495767836,0.545615589016829,364,426,0.8544600938967136,78,361,439,199,106,24,121,87,1596,SF,TOR
Meyers Leonard,26,61,2,878,132,242,0.5454545454545454,50,111,0.45045045045045046,82,131,0.6259541984732825,0.6487603305785123,43,51,0.8431372549019608,49,184,233,75,13,9,43,105,357,C,POR
Jon Leuer,29,41,1,402,66,113,0.584070796460177,1,11,0.09090909090909091,65,102,0.6372549019607843,0.588495575221239,23,31,0.7419354838709677,27,70,97,14,12,4,23,60,156,PF,DET
Caris LeVert,24,40,25,1063,207,483,0.42857142857142855,48,154,0.3116883116883117,159,329,0.48328267477203646,0.4782608695652174,85,123,0.6910569105691057,35,116,151,156,42,14,69,77,547,SF,BRK
Damian Lillard,28,80,80,2838,681,1533,0.44422700587084146,237,643,0.36858475894245724,444,890,0.49887640449438203,0.5215264187866928,468,513,0.9122807017543859,68,303,371,551,88,34,212,148,2067,PG,POR
Jeremy Lin,30,148,8,2872,476,1082,0.4399260628465804,110,374,0.29411764705882354,366,708,0.5169491525423728,0.4907578558225508,352,420,0.8380952380952381,44,314,358,462,94,26,248,288,1414,PG,TOT
Shaun Livingston,33,64,0,967,109,210,0.5190476190476191,0,2,0,109,208,0.5240384615384616,0.5190476190476191,40,51,0.7843137254901961,42,75,117,114,31,27,38,74,258,PG,GSW
Zach Lofton,26,1,0,4,0,1,0,0,1,0,0,0,0,0,0,0,0,0,0,0,0,1,0,1,0,0,SG,DET
Kevon Looney,22,80,24,1481,217,347,0.6253602305475504,1,10,0.1,216,337,0.6409495548961425,0.6268011527377522,65,105,0.6190476190476191,194,223,417,123,46,53,51,211,500,C,GSW
Brook Lopez,30,81,81,2322,355,786,0.45165394402035625,187,512,0.365234375,168,274,0.6131386861313869,0.5706106870229007,112,133,0.8421052631578947,33,363,396,98,51,179,82,189,1009,C,MIL
Robin Lopez,30,74,36,1606,304,535,0.5682242990654206,7,31,0.22580645161290322,297,504,0.5892857142857143,0.5747663551401869,89,123,0.7235772357723578,140,146,286,89,11,78,96,124,704,C,CHI
Kevin Love,30,22,21,598,109,283,0.38515901060070673,53,147,0.36054421768707484,56,136,0.4117647058823529,0.4787985865724382,103,114,0.9035087719298246,33,206,239,48,6,5,42,54,374,PF,CLE
Kyle Lowry,32,65,65,2213,304,739,0.41136671177266576,157,453,0.3465783664459161,147,286,0.513986013986014,0.5175913396481732,161,194,0.8298969072164949,41,271,312,564,91,31,182,166,926,PG,TOR
Jordan Loyd,25,12,0,55,8,18,0.4444444444444444,4,8,0.5,4,10,0.4,0.5555555555555556,9,11,0.8181818181818182,1,8,9,6,0,0,2,5,29,PG,TOR
Kalin Lucas,29,1,0,6,0,1,0,0,1,0,0,0,0,0,2,2,1,0,3,3,1,0,0,0,1,2,PG,DET
Timothe Luwawu-Cabarrot,23,100,14,1338,164,436,0.3761467889908257,72,232,0.3103448275862069,92,204,0.45098039215686275,0.45871559633027525,62,82,0.7560975609756098,22,172,194,52,38,16,42,146,462,SF,TOT
Tyler Lydon,22,25,0,94,9,18,0.5,4,10,0.4,5,8,0.625,0.6111111111111112,1,3,0.3333333333333333,7,11,18,6,2,0,4,10,23,PF,DEN
Trey Lyles,23,64,2,1120,207,495,0.41818181818181815,51,200,0.255,156,295,0.5288135593220339,0.4696969696969697,81,116,0.6982758620689655,44,202,246,87,30,23,68,93,546,PF,DEN
Scott Machado,28,4,0,19,4,6,0.6666666666666666,1,1,1,3,5,0.6,0.75,1,1,1,0,0,0,3,1,0,0,2,10,PG,LAL
Shelvin Mack,28,114,6,2492,326,806,0.4044665012406948,92,260,0.35384615384615387,234,546,0.42857142857142855,0.46153846153846156,116,168,0.6904761904761905,36,172,208,366,94,8,132,168,860,PG,TOT
Daryl Macon,23,8,0,90,10,27,0.37037037037037035,5,11,0.45454545454545453,5,16,0.3125,0.46296296296296297,4,7,0.5714285714285714,2,10,12,7,1,0,6,8,29,SG,DAL
JP Macura,23,2,0,17,3,9,0.3333333333333333,0,4,0,3,5,0.6,0.3333333333333333,0,0,0,0,3,3,2,0,0,0,0,6,SG,CHO
Ian Mahinmi,32,34,6,498,47,104,0.4519230769230769,3,16,0.1875,44,88,0.5,0.46634615384615385,42,61,0.6885245901639344,48,80,128,25,25,16,21,84,139,C,WAS
Thon Maker,21,128,10,1944,218,536,0.40671641791044777,98,306,0.3202614379084967,120,230,0.5217391304347826,0.498134328358209,112,168,0.6666666666666666,82,322,404,90,42,102,66,210,646,C,TOT
Boban Marjanovic,30,116,24,1362,320,520,0.6153846153846154,8,20,0.4,312,500,0.624,0.6230769230769231,196,262,0.7480916030534351,174,356,530,108,32,54,118,180,844,C,TOT
Lauri Markkanen,21,52,51,1682,342,795,0.43018867924528303,120,332,0.3614457831325301,222,463,0.4794816414686825,0.5056603773584906,170,195,0.8717948717948718,74,396,470,75,37,33,85,122,974,PF,CHI
Jarell Martin,24,42,1,328,43,104,0.41346153846153844,20,57,0.3508771929824561,23,47,0.48936170212765956,0.5096153846153846,9,11,0.8181818181818182,11,62,73,18,3,8,11,51,115,PF,ORL
Frank Mason,24,38,0,435,71,169,0.42011834319526625,14,64,0.21875,57,105,0.5428571428571428,0.46153846153846156,39,57,0.6842105263157895,6,37,43,84,16,4,36,34,195,PG,SAC
Yante Maten,22,2,0,13,1,4,0.25,0,1,0,1,3,0.3333333333333333,0.25,0,0,0,1,2,3,0,1,0,0,0,2,PF,MIA
Wesley Matthews,32,138,136,4182,558,1396,0.3997134670487106,300,806,0.37220843672456577,258,590,0.43728813559322033,0.5071633237822349,264,326,0.8098159509202454,64,276,340,320,108,34,182,320,1680,SF,TOT
Luc Mbah a Moute,32,4,0,61,8,18,0.4444444444444444,2,6,0.3333333333333333,6,12,0.5,0.5,2,5,0.4,2,5,7,2,1,1,2,8,20,PF,LAC
Tahjere McCall,24,1,0,8,2,3,0.6666666666666666,0,1,0,2,2,1,0.6666666666666666,0,1,0,0,1,1,0,0,0,0,2,4,SG,BRK
Patrick McCaw,23,58,2,794,52,126,0.4126984126984127,18,56,0.32142857142857145,34,70,0.4857142857142857,0.48412698412698413,26,30,0.8666666666666667,14,82,96,58,46,4,34,76,148,SG,TOT
CJ McCollum,27,70,70,2375,571,1243,0.4593724859211585,167,445,0.3752808988764045,404,798,0.506265664160401,0.5265486725663717,159,192,0.828125,62,220,282,207,55,28,106,172,1468,SG,POR
TJ McConnell,26,76,3,1470,220,419,0.5250596658711217,14,42,0.3333333333333333,206,377,0.5464190981432361,0.5417661097852029,29,37,0.7837837837837838,28,146,174,258,79,17,91,105,483,PG,PHI
Doug McDermott,27,77,1,1340,207,422,0.490521327014218,84,206,0.4077669902912621,123,216,0.5694444444444444,0.590047393364929,66,79,0.8354430379746836,17,92,109,67,18,8,42,104,564,SF,IND
JaVale McGee,31,75,62,1671,400,641,0.62402496099844,1,12,0.08333333333333333,399,629,0.6343402225755167,0.624804992199688,96,152,0.631578947368421,195,371,566,52,47,148,108,208,897,C,LAL
Rodney McGruder,27,66,45,1550,186,461,0.403470715835141,79,225,0.3511111111111111,107,236,0.4533898305084746,0.4891540130151844,52,72,0.7222222222222222,60,178,238,112,36,12,64,115,503,SG,MIA
Alfonzo McKinnie,26,72,5,1003,134,275,0.48727272727272725,42,118,0.3559322033898305,92,157,0.5859872611464968,0.5636363636363636,27,48,0.5625,81,166,247,31,18,15,30,134,337,SF,GSW
Ben McLemore,25,19,0,158,25,64,0.390625,17,41,0.4146341463414634,8,23,0.34782608695652173,0.5234375,8,12,0.6666666666666666,3,14,17,4,6,3,5,22,75,SG,SAC
Jordan McRae,27,27,0,333,61,130,0.46923076923076923,10,35,0.2857142857142857,51,95,0.5368421052631579,0.5076923076923077,28,35,0.8,6,34,40,30,13,7,15,26,160,SG,WAS
Jodie Meeks,31,8,0,104,21,39,0.5384615384615384,8,18,0.4444444444444444,13,21,0.6190476190476191,0.6410256410256411,1,1,1,1,11,12,8,1,1,2,5,51,SG,TOR
Salah Mejri,32,36,4,399,55,112,0.49107142857142855,11,34,0.3235294117647059,44,78,0.5641025641025641,0.5401785714285714,20,32,0.625,36,95,131,35,10,26,21,55,141,C,DAL
De'Anthony Melton,20,50,31,984,100,256,0.390625,29,95,0.30526315789473685,71,161,0.4409937888198758,0.447265625,21,28,0.75,25,109,134,159,68,23,75,113,250,PG,PHO
Chimezie Metu,21,29,0,145,19,58,0.3275862068965517,0,2,0,19,56,0.3392857142857143,0.3275862068965517,13,17,0.7647058823529411,9,27,36,13,6,2,15,14,51,PF,SAS
Khris Middleton,27,77,77,2393,506,1148,0.44076655052264807,179,474,0.37763713080168776,327,674,0.48516320474777447,0.5187282229965157,216,258,0.8372093023255814,50,411,461,331,80,7,174,172,1407,SF,MIL
CJ Miles,31,106,2,1712,224,622,0.36012861736334406,134,406,0.33004926108374383,90,216,0.4166666666666667,0.4678456591639871,96,116,0.8275862068965517,26,164,190,72,52,30,60,158,678,SF,TOT
Darius Miller,28,69,15,1757,189,484,0.390495867768595,133,364,0.36538461538461536,56,120,0.4666666666666667,0.5278925619834711,56,71,0.7887323943661971,14,114,128,146,40,23,59,165,567,SF,NOP
Malcolm Miller,25,10,0,67,11,26,0.4230769230769231,10,21,0.47619047619047616,1,5,0.2,0.6153846153846154,3,4,0.75,1,4,5,1,1,1,1,5,35,SF,TOR
Patty Mills,30,82,1,1908,282,663,0.4253393665158371,159,404,0.3935643564356436,123,259,0.4749034749034749,0.5452488687782805,88,103,0.8543689320388349,24,158,182,245,49,10,93,129,811,PG,SAS
Paul Millsap,33,70,65,1895,322,665,0.4842105263157895,58,159,0.36477987421383645,264,506,0.5217391304347826,0.5278195488721804,181,249,0.7269076305220884,153,352,505,141,83,54,95,183,883,PF,DEN
Shake Milton,22,20,0,268,34,87,0.39080459770114945,14,44,0.3181818181818182,20,43,0.46511627906976744,0.47126436781609193,5,7,0.7142857142857143,9,26,35,18,8,8,6,29,87,SG,PHI
Nikola Mirotic,27,92,50,2490,476,1084,0.43911439114391143,232,636,0.36477987421383645,244,448,0.5446428571428571,0.5461254612546126,210,248,0.8467741935483871,120,558,678,110,62,68,96,214,1394,PF,TOT
Donovan Mitchell,22,77,77,2598,661,1530,0.4320261437908497,188,519,0.3622350674373796,473,1011,0.4678536102868447,0.4934640522875817,319,396,0.8055555555555556,59,257,316,322,106,31,218,208,1829,SG,UTA
Naz Mitrou-Long,25,14,0,84,6,20,0.3,2,11,0.18181818181818182,4,9,0.4444444444444444,0.35,2,2,1,1,5,6,15,1,1,8,10,16,SG,UTA
Malik Monk,20,73,0,1258,227,586,0.3873720136518771,109,330,0.3303030303030303,118,256,0.4609375,0.4803754266211604,90,102,0.8823529411764706,16,121,137,117,37,19,86,106,653,SG,CHO
Greg Monroe,28,86,4,960,184,378,0.48677248677248675,2,10,0.2,182,368,0.4945652173913043,0.4894179894179894,90,144,0.625,134,210,344,48,28,16,64,132,460,C,TOT
E'Twaun Moore,29,53,36,1463,256,532,0.48120300751879697,76,176,0.4318181818181818,180,356,0.5056179775280899,0.5526315789473685,45,59,0.7627118644067796,35,92,127,102,40,8,59,112,633,SG,NOP
Eric Moreland,27,10,0,86,6,14,0.42857142857142855,2,2,1,4,12,0.3333333333333333,0.5,0,0,0,8,32,40,8,2,2,10,18,14,PF,TOT
Jaylen Morris,23,4,0,29,4,10,0.4,1,3,0.3333333333333333,3,7,0.42857142857142855,0.45,1,2,0.5,0,5,5,4,2,0,1,1,10,SG,MIL
Marcus Morris,29,75,53,2091,377,844,0.4466824644549763,146,389,0.37532133676092544,231,455,0.5076923076923077,0.533175355450237,146,173,0.8439306358381503,76,382,458,109,43,25,92,181,1046,PF,BOS
Markieff Morris,29,116,32,2540,408,968,0.4214876033057851,136,406,0.33497536945812806,272,562,0.48398576512455516,0.49173553719008267,142,184,0.7717391304347826,122,408,530,158,72,44,108,350,1094,PF,TOT
Monte Morris,23,82,6,1970,346,702,0.4928774928774929,94,227,0.41409691629955947,252,475,0.5305263157894737,0.5598290598290598,65,81,0.8024691358024691,35,159,194,297,73,4,52,102,851,PG,DEN
Donatas Motiejunas,28,3,0,13,3,6,0.5,0,0,0,3,6,0.5,0.5,0,2,0,2,1,3,1,0,1,3,6,6,PF,SAS
Johnathan Motley,23,22,0,156,39,73,0.5342465753424658,0,3,0,39,70,0.5571428571428572,0.5342465753424658,24,40,0.6,18,33,51,11,5,3,16,27,102,PF,LAC
Emmanuel Mudiay,22,59,42,1607,330,740,0.44594594594594594,69,210,0.32857142857142857,261,530,0.49245283018867925,0.4925675675675676,144,186,0.7741935483870968,33,163,196,228,43,19,140,103,873,PG,NYK
Jamal Murray,21,75,74,2447,513,1173,0.4373401534526854,152,414,0.3671497584541063,361,759,0.4756258234519104,0.5021312872975278,189,223,0.8475336322869955,65,252,317,363,67,27,158,153,1367,PG,DEN
Dzanan Musa,19,9,0,39,9,22,0.4090909090909091,1,10,0.1,8,12,0.6666666666666666,0.4318181818181818,0,2,0,1,4,5,2,2,0,4,1,19,SG,BRK
Mike Muscala,27,128,20,2612,290,722,0.40166204986149584,178,512,0.34765625,112,210,0.5333333333333333,0.5249307479224377,140,170,0.8235294117647058,114,374,488,152,44,76,96,260,898,PF,TOT
Sviatoslav Mykhailiuk,21,84,0,880,92,280,0.32857142857142857,58,178,0.3258426966292135,34,102,0.3333333333333333,0.43214285714285716,24,40,0.6,18,54,72,74,28,2,42,50,266,SF,TOT
Abdel Nader,25,61,1,694,91,215,0.4232558139534884,32,100,0.32,59,115,0.5130434782608696,0.49767441860465117,27,36,0.75,14,102,116,20,20,12,26,68,241,SF,OKC
Larry Nance,26,67,30,1795,249,479,0.5198329853862212,33,98,0.336734693877551,216,381,0.5669291338582677,0.5542797494780793,96,134,0.7164179104477612,168,384,552,214,100,40,97,192,627,C,CLE
Shabazz Napier,27,56,2,983,169,435,0.38850574712643676,76,228,0.3333333333333333,93,207,0.4492753623188406,0.47586206896551725,115,138,0.8333333333333334,18,82,100,143,41,16,66,67,529,PG,BRK
Raul Neto,26,37,1,474,74,161,0.45962732919254656,20,60,0.3333333333333333,54,101,0.5346534653465347,0.5217391304347826,28,33,0.8484848484848485,6,56,62,93,14,4,35,49,196,PG,UTA
Georges Niang,25,59,0,516,86,181,0.47513812154696133,43,105,0.4095238095238095,43,76,0.5657894736842105,0.5939226519337016,20,24,0.8333333333333334,11,76,87,35,10,6,23,57,235,PF,UTA
Joakim Noah,33,42,1,693,110,213,0.5164319248826291,0,1,0,110,212,0.5188679245283019,0.5164319248826291,78,109,0.7155963302752294,58,180,238,89,20,31,50,96,298,C,MEM
Nerlens Noel,24,77,2,1055,162,276,0.5869565217391305,0,0,0,162,276,0.5869565217391305,0.5869565217391305,54,79,0.6835443037974683,127,198,325,45,66,96,48,166,378,C,OKC
Dirk Nowitzki,40,51,20,795,135,376,0.35904255319148937,64,205,0.3121951219512195,71,171,0.4152046783625731,0.4441489361702128,39,50,0.78,5,153,158,35,9,18,18,76,373,PF,DAL
Frank Ntilikina,20,43,16,904,95,282,0.33687943262411346,33,115,0.28695652173913044,62,167,0.3712574850299401,0.3953900709219858,23,30,0.7666666666666667,12,75,87,121,30,14,56,104,246,PG,NYK
James Nunnally,28,30,0,204,24,68,0.35294117647058826,16,50,0.32,8,18,0.4444444444444444,0.47058823529411764,8,8,1,0,10,10,14,2,0,2,20,72,SF,TOT
Jusuf Nurkic,24,72,72,1974,420,826,0.5084745762711864,3,29,0.10344827586206896,417,797,0.5232120451693852,0.5102905569007264,282,365,0.7726027397260274,243,505,748,233,71,103,168,250,1125,C,POR
David Nwaba,26,51,14,984,126,262,0.48091603053435117,24,75,0.32,102,187,0.5454545454545454,0.5267175572519084,58,85,0.6823529411764706,41,122,163,54,36,17,29,106,334,SG,CLE
Royce O'Neale,25,82,16,1671,163,343,0.4752186588921283,68,176,0.38636363636363635,95,167,0.5688622754491018,0.5743440233236151,32,42,0.7619047619047619,22,263,285,124,54,24,70,172,426,SF,UTA
Kyle O'Quinn,28,45,3,371,69,136,0.5073529411764706,1,12,0.08333333333333333,68,124,0.5483870967741935,0.5110294117647058,17,21,0.8095238095238095,29,90,119,56,9,25,31,68,156,C,IND
Semi Ojeleye,24,56,3,594,67,158,0.4240506329113924,28,89,0.3146067415730337,39,69,0.5652173913043478,0.5126582278481012,24,39,0.6153846153846154,24,62,86,23,10,4,19,43,186,PF,BOS
Jahlil Okafor,23,59,24,935,212,362,0.585635359116022,1,5,0.2,211,357,0.5910364145658263,0.5870165745856354,59,89,0.6629213483146067,82,196,278,40,15,40,52,96,484,C,NOP
Elie Okobo,21,53,16,958,114,290,0.3931034482758621,39,132,0.29545454545454547,75,158,0.47468354430379744,0.4603448275862069,37,47,0.7872340425531915,12,86,98,127,32,7,69,109,304,PG,PHO
Josh Okogie,20,74,52,1757,196,508,0.3858267716535433,60,215,0.27906976744186046,136,293,0.4641638225255973,0.4448818897637795,118,162,0.7283950617283951,41,177,218,91,88,33,63,166,570,SG,MIN
Victor Oladipo,26,36,36,1147,249,588,0.42346938775510207,74,216,0.3425925925925926,175,372,0.47043010752688175,0.48639455782312924,103,141,0.7304964539007093,21,181,202,186,60,11,82,72,675,SG,IND
Kelly Olynyk,27,79,36,1812,261,564,0.4627659574468085,113,319,0.3542319749216301,148,245,0.6040816326530613,0.5629432624113475,152,185,0.8216216216216217,72,303,375,140,53,37,114,183,787,PF,MIA
Cedi Osman,23,76,75,2444,360,844,0.4265402843601896,130,374,0.34759358288770054,230,470,0.48936170212765956,0.5035545023696683,141,181,0.7790055248618785,45,312,357,195,60,11,114,195,991,SF,CLE
Kelly Oubre,23,138,38,3870,750,1684,0.44536817102137766,216,676,0.31952662721893493,534,1008,0.5297619047619048,0.5095011876484561,378,488,0.7745901639344263,142,508,650,168,168,118,206,362,2094,SF,TOT
Zaza Pachulia,34,68,3,878,85,193,0.44041450777202074,0,4,0,85,189,0.4497354497354497,0.44041450777202074,97,124,0.782258064516129,99,166,265,91,31,17,57,151,267,C,DET
Jabari Parker,23,128,34,3448,738,1498,0.49265687583444595,122,390,0.3128205128205128,616,1108,0.555956678700361,0.5333778371161548,262,368,0.7119565217391305,158,684,842,304,92,60,302,290,1860,PF,TOT
Tony Parker,36,56,0,1003,213,463,0.46004319654427644,13,51,0.2549019607843137,200,412,0.4854368932038835,0.4740820734341253,91,124,0.7338709677419355,14,69,83,207,21,7,75,53,530,PG,CHO
Chandler Parsons,30,25,3,496,68,182,0.37362637362637363,29,94,0.30851063829787234,39,88,0.4431818181818182,0.4532967032967033,22,25,0.88,4,66,70,43,19,5,32,45,187,SF,MEM
Patrick Patterson,29,63,5,861,82,219,0.3744292237442922,46,137,0.3357664233576642,36,82,0.43902439024390244,0.4794520547945205,19,30,0.6333333333333333,42,105,147,31,16,13,22,46,229,PF,OKC
Justin Patton,21,3,0,21,2,7,0.2857142857142857,0,2,0,2,5,0.4,0.2857142857142857,1,2,0.5,2,4,6,3,2,0,0,5,5,C,PHI
Chris Paul,33,58,58,1857,302,720,0.41944444444444445,127,355,0.35774647887323946,175,365,0.4794520547945205,0.5076388888888889,175,203,0.8620689655172413,36,229,265,473,114,18,152,146,906,PG,HOU
Cameron Payne,24,80,26,1424,192,446,0.4304932735426009,50,168,0.2976190476190476,142,278,0.5107913669064749,0.48654708520179374,66,82,0.8048780487804879,26,118,144,212,56,18,90,128,500,PG,TOT
Elfrid Payton,24,42,42,1250,179,412,0.4344660194174757,33,105,0.3142857142857143,146,307,0.4755700325732899,0.47451456310679613,55,74,0.7432432432432432,49,171,220,320,44,17,112,81,446,PG,NOP
Gary Payton,26,3,0,16,5,8,0.625,1,2,0.5,4,6,0.6666666666666666,0.6875,0,0,0,1,1,2,4,3,1,1,2,11,PG,WAS
Theo Pinson,23,18,0,211,25,73,0.3424657534246575,12,46,0.2608695652173913,13,27,0.48148148148148145,0.4246575342465753,19,22,0.8636363636363636,4,32,36,21,6,0,18,15,81,SG,BRK
Mason Plumlee,28,82,17,1731,262,442,0.5927601809954751,2,10,0.2,260,432,0.6018518518518519,0.5950226244343891,111,198,0.5606060606060606,165,359,524,243,66,76,126,252,637,C,DEN
Miles Plumlee,30,18,0,173,32,48,0.6666666666666666,0,0,0,32,48,0.6666666666666666,0.6666666666666666,16,30,0.5333333333333333,16,23,39,17,6,4,10,14,80,C,ATL
Quincy Pondexter,30,53,0,292,29,58,0.5,6,18,0.3333333333333333,23,40,0.575,0.5517241379310345,34,42,0.8095238095238095,8,38,46,24,11,1,13,24,98,SF,SAS
Otto Porter,25,112,86,3366,598,1286,0.46500777604976673,208,512,0.40625,390,774,0.5038759689922481,0.5458786936236392,156,192,0.8125,108,520,628,240,164,62,130,216,1560,SF,TOT
Bobby Portis,23,100,56,2598,558,1256,0.4442675159235669,150,382,0.39267015706806285,408,874,0.4668192219679634,0.5039808917197452,154,194,0.7938144329896907,218,588,806,144,70,40,148,290,1420,PF,TOT
Dwight Powell,27,77,22,1662,290,486,0.5967078189300411,39,127,0.30708661417322836,251,359,0.6991643454038997,0.6368312757201646,196,254,0.7716535433070866,140,271,411,112,44,50,67,201,815,C,DAL
Norman Powell,25,60,3,1126,193,400,0.4825,68,170,0.4,125,230,0.5434782608695652,0.5675,62,75,0.8266666666666667,16,123,139,91,39,13,65,96,516,SG,TOR
Alex Poythress,25,21,1,305,40,81,0.49382716049382713,9,23,0.391304347826087,31,58,0.5344827586206896,0.5493827160493827,18,29,0.6206896551724138,29,47,76,17,4,10,13,47,107,PF,ATL
Jakob Poltl,23,77,24,1273,187,290,0.6448275862068965,0,0,0,187,290,0.6448275862068965,0.6448275862068965,49,92,0.532608695652174,178,232,410,93,29,68,48,124,423,C,SAS
Zhou Qi,23,1,0,1,1,1,1,0,0,0,1,1,1,1,0,0,0,0,0,0,0,0,0,0,0,2,PF,HOU
Ivan Rabb,21,49,13,721,116,212,0.5471698113207547,3,15,0.2,113,197,0.5736040609137056,0.5542452830188679,49,69,0.7101449275362319,70,136,206,54,17,14,35,90,284,PF,MEM
Chasson Randle,25,49,2,743,91,217,0.41935483870967744,46,115,0.4,45,102,0.4411764705882353,0.5253456221198156,43,62,0.6935483870967742,10,46,56,97,25,3,43,91,271,PG,WAS
Julius Randle,24,73,49,2232,571,1089,0.5243342516069789,67,195,0.3435897435897436,504,894,0.5637583892617449,0.5550964187327824,356,487,0.731006160164271,162,472,634,229,52,45,208,246,1565,PF,NOP
JJ Redick,34,76,63,2379,452,1027,0.44011684518013633,240,605,0.39669421487603307,212,422,0.5023696682464455,0.5569620253164557,228,255,0.8941176470588236,20,166,186,206,32,17,101,129,1372,SG,PHI
Davon Reed,23,10,0,47,5,12,0.4166666666666667,2,4,0.5,3,8,0.375,0.5,0,0,0,2,4,6,3,1,0,1,3,12,SG,IND
Cameron Reynolds,23,19,0,259,33,78,0.4230769230769231,21,51,0.4117647058823529,12,27,0.4444444444444444,0.5576923076923077,8,9,0.8888888888888888,4,27,31,13,6,2,5,26,95,SG,MIN
Josh Richardson,25,73,73,2539,423,1026,0.41228070175438597,164,460,0.3565217391304348,259,566,0.4575971731448763,0.4922027290448343,199,231,0.8614718614718615,54,209,263,298,79,34,113,200,1209,SG,MIA
Malachi Richardson,23,22,0,103,9,29,0.3103448275862069,8,25,0.32,1,4,0.25,0.4482758620689655,4,5,0.8,2,11,13,0,1,0,8,13,30,SG,TOR
Austin Rivers,26,152,30,4056,464,1144,0.40559440559440557,208,654,0.3180428134556575,256,490,0.5224489795918368,0.4965034965034965,100,190,0.5263157894736842,50,274,324,334,94,46,136,414,1236,SG,TOT
Devin Robinson,23,7,0,95,19,32,0.59375,0,2,0,19,30,0.6333333333333333,0.59375,9,14,0.6428571428571429,6,14,20,6,4,6,2,11,47,SF,WAS
Duncan Robinson,24,15,1,161,18,46,0.391304347826087,10,35,0.2857142857142857,8,11,0.7272727272727273,0.5,4,6,0.6666666666666666,2,17,19,5,5,0,4,11,50,PF,MIA
Glenn Robinson,25,47,18,610,74,176,0.42045454545454547,18,62,0.2903225806451613,56,114,0.49122807017543857,0.4715909090909091,32,40,0.8,17,54,71,21,14,8,18,45,198,SF,DET
Jerome Robinson,21,33,0,320,44,110,0.4,18,57,0.3157894736842105,26,53,0.49056603773584906,0.4818181818181818,6,9,0.6666666666666666,3,38,41,19,11,3,13,46,112,SG,LAC
Mitchell Robinson,20,66,19,1360,202,291,0.6941580756013745,0,0,0,202,291,0.6941580756013745,0.6941580756013745,81,135,0.6,177,246,423,37,52,161,35,217,485,C,NYK
Rajon Rondo,32,46,29,1369,175,432,0.4050925925925926,51,142,0.3591549295774648,124,290,0.42758620689655175,0.46412037037037035,23,36,0.6388888888888888,34,209,243,367,57,7,127,100,424,PG,LAL
Derrick Rose,30,51,13,1392,363,753,0.4820717131474104,54,146,0.3698630136986301,309,607,0.5090609555189456,0.5179282868525896,137,160,0.85625,33,107,140,220,31,12,82,57,917,PG,MIN
Terrence Ross,27,81,0,2150,440,1027,0.42843232716650437,217,566,0.3833922261484099,223,461,0.4837310195227766,0.5340798442064265,126,144,0.875,27,253,280,135,72,29,90,119,1223,SG,ORL
Terry Rozier,24,79,14,1791,258,666,0.38738738738738737,119,337,0.35311572700296734,139,329,0.42249240121580545,0.4767267267267267,73,93,0.7849462365591398,32,275,307,231,68,21,68,101,708,PG,BOS
Ricky Rubio,28,68,67,1899,295,730,0.4041095890410959,79,254,0.3110236220472441,216,476,0.453781512605042,0.45821917808219176,195,228,0.8552631578947368,33,210,243,416,91,10,180,180,864,PG,UTA
D'Angelo Russell,22,81,81,2448,659,1517,0.43441001977587346,234,635,0.36850393700787404,425,882,0.481859410430839,0.5115359261700725,160,205,0.7804878048780488,53,262,315,563,100,20,253,141,1712,PG,BRK
Domantas Sabonis,22,74,5,1838,413,700,0.59,9,17,0.5294117647058824,404,683,0.5915080527086384,0.5964285714285714,208,291,0.7147766323024055,186,504,690,212,48,30,160,239,1043,C,IND
Brandon Sampson,21,14,2,214,28,60,0.4666666666666667,11,29,0.3793103448275862,17,31,0.5483870967741935,0.5583333333333333,4,6,0.6666666666666666,3,13,16,10,8,3,12,19,71,SG,CHI
JaKarr Sampson,25,4,0,127,29,54,0.5370370370370371,5,14,0.35714285714285715,24,40,0.6,0.5833333333333334,17,21,0.8095238095238095,5,27,32,4,4,3,4,8,80,SF,CHI
Tomas Satoransky,27,80,54,2164,257,530,0.4849056603773585,64,162,0.3950617283950617,193,368,0.5244565217391305,0.5452830188679245,131,160,0.81875,82,197,279,399,82,13,120,172,709,PG,WAS
Dennis Schroder,25,79,14,2314,457,1104,0.41394927536231885,124,364,0.34065934065934067,333,740,0.45,0.4701086956521739,186,227,0.8193832599118943,38,246,284,323,65,12,172,189,1224,PG,OKC
Mike Scott,30,158,6,2790,336,840,0.4,202,504,0.4007936507936508,134,336,0.39880952380952384,0.5202380952380953,44,66,0.6666666666666666,86,466,552,132,52,26,88,312,918,PF,TOT
Thabo Sefolosha,34,50,2,609,71,149,0.47651006711409394,34,78,0.4358974358974359,37,71,0.5211267605633803,0.5906040268456376,14,22,0.6363636363636364,8,115,123,27,43,5,25,41,190,SF,UTA
Wayne Selden,24,150,26,2878,392,966,0.4057971014492754,110,348,0.3160919540229885,282,618,0.4563106796116505,0.46273291925465837,134,184,0.7282608695652174,74,286,360,218,66,26,158,262,1028,SG,TOT
Collin Sexton,20,82,72,2605,519,1206,0.43034825870646765,119,296,0.40202702702702703,400,910,0.43956043956043955,0.4796849087893864,214,255,0.8392156862745098,57,179,236,243,44,6,185,186,1371,PG,CLE
Landry Shamet,21,158,54,3604,480,1114,0.43087971274685816,334,792,0.4217171717171717,146,322,0.453416149068323,0.5807899461400359,150,186,0.8064516129032258,42,226,268,234,74,20,90,310,1444,SG,TOT
Iman Shumpert,28,124,82,2962,334,892,0.3744394618834081,190,546,0.34798534798534797,144,346,0.4161849710982659,0.48094170403587444,72,90,0.8,54,312,366,224,118,48,100,254,930,SG,TOT
Pascal Siakam,24,80,79,2548,519,945,0.5492063492063493,79,214,0.3691588785046729,440,731,0.6019151846785226,0.591005291005291,237,302,0.7847682119205298,124,425,549,248,73,52,154,241,1354,PF,TOR
Jordan Sibert,26,1,0,4,1,1,1,1,1,1,0,0,0,1.5,0,0,0,0,0,0,0,0,0,0,0,3,SG,ATL
Ben Simmons,22,79,79,2700,540,960,0.5625,0,6,0,540,954,0.5660377358490566,0.5625,257,428,0.6004672897196262,172,525,697,610,112,61,274,209,1337,PG,PHI
Jonathon Simmons,29,112,18,2128,266,700,0.38,56,208,0.2692307692307692,210,492,0.4268292682926829,0.42,144,194,0.7422680412371134,54,198,252,256,58,30,136,178,732,SG,TOT
Kobi Simmons,21,1,0,2,0,0,0,0,0,0,0,0,0,0,0,0,0,0,0,0,0,0,0,0,0,0,PG,CLE
Anfernee Simons,19,20,1,141,28,63,0.4444444444444444,10,29,0.3448275862068966,18,34,0.5294117647058824,0.5238095238095238,9,16,0.5625,3,10,13,13,1,0,11,9,75,SG,POR
Marcus Smart,24,80,60,2200,239,567,0.42151675485008816,126,346,0.36416184971098264,113,221,0.5113122171945701,0.5326278659611993,104,129,0.8062015503875969,57,177,234,321,143,28,123,201,708,SG,BOS
Dennis Smith,21,106,100,3016,556,1300,0.4276923076923077,134,416,0.32211538461538464,422,884,0.47737556561085975,0.47923076923076924,198,312,0.6346153846153846,64,246,310,504,134,40,308,258,1444,PG,TOT
Ish Smith,30,56,0,1251,205,489,0.41922290388548056,44,135,0.32592592592592595,161,354,0.4548022598870056,0.46421267893660534,47,62,0.7580645161290323,23,122,145,203,28,11,61,109,501,PG,DET
JR Smith,33,11,4,222,27,79,0.34177215189873417,12,39,0.3076923076923077,15,40,0.375,0.4177215189873418,8,10,0.8,0,18,18,21,11,3,11,19,74,SG,CLE
Jason Smith,32,40,2,380,42,118,0.3559322033898305,18,52,0.34615384615384615,24,66,0.36363636363636365,0.4322033898305085,28,32,0.875,32,72,104,28,6,14,26,60,130,C,TOT
Zhaire Smith,19,6,2,111,14,34,0.4117647058823529,6,16,0.375,8,18,0.4444444444444444,0.5,6,8,0.75,3,10,13,10,2,2,6,8,40,SG,PHI
Tony Snell,27,74,12,1304,163,361,0.4515235457063712,81,204,0.39705882352941174,82,157,0.5222929936305732,0.5637119113573407,37,42,0.8809523809523809,29,128,157,68,26,18,23,90,444,SF,MIL
Ray Spalding,21,28,6,296,50,94,0.5319148936170213,0,6,0,50,88,0.5681818181818182,0.5319148936170213,8,24,0.3333333333333333,30,66,96,10,18,16,18,46,108,PF,TOT
Omari Spellman,21,46,11,805,98,244,0.4016393442622951,44,128,0.34375,54,116,0.46551724137931033,0.4918032786885246,32,45,0.7111111111111111,72,122,194,47,26,25,31,67,272,PF,ATL
Nik Stauskas,25,136,0,2030,272,676,0.40236686390532544,140,376,0.3723404255319149,132,300,0.44,0.5059171597633136,114,128,0.890625,36,218,254,162,42,14,102,100,798,SG,TOT
DJ Stephens,28,1,0,7,1,2,0.5,0,0,0,1,2,0.5,0.5,0,0,0,0,0,0,0,1,0,1,0,2,SG,MEM
Lance Stephenson,28,68,3,1123,184,432,0.42592592592592593,73,197,0.37055837563451777,111,235,0.4723404255319149,0.5104166666666666,50,73,0.684931506849315,32,183,215,140,41,7,86,111,491,SG,LAL
Edmond Sumner,23,23,2,210,22,64,0.34375,7,27,0.25925925925925924,15,37,0.40540540540540543,0.3984375,15,24,0.625,9,15,24,10,12,5,10,26,66,PG,IND
Caleb Swanigan,21,42,0,356,36,106,0.33962264150943394,2,14,0.14285714285714285,34,92,0.3695652173913043,0.3490566037735849,12,18,0.6666666666666666,34,94,128,22,12,2,36,56,86,PF,TOT
Jayson Tatum,20,79,79,2455,466,1036,0.4498069498069498,116,311,0.3729903536977492,350,725,0.4827586206896552,0.5057915057915058,195,228,0.8552631578947368,70,407,477,168,84,57,122,168,1243,SF,BOS
Jeff Teague,30,42,41,1264,176,416,0.4230769230769231,35,105,0.3333333333333333,141,311,0.45337620578778137,0.4651442307692308,123,153,0.803921568627451,16,90,106,343,43,18,97,90,510,PG,MIN
Garrett Temple,32,150,110,4080,416,986,0.42190669371196754,180,528,0.3409090909090909,236,458,0.5152838427947598,0.513184584178499,160,214,0.7476635514018691,56,376,432,212,152,60,140,408,1172,SG,TOT
Milos Teodosic,31,15,0,150,17,40,0.425,10,27,0.37037037037037035,7,13,0.5384615384615384,0.55,4,7,0.5714285714285714,3,13,16,32,3,1,21,27,48,PG,LAC
Jared Terrell,23,14,0,111,12,39,0.3076923076923077,4,17,0.23529411764705882,8,22,0.36363636363636365,0.358974358974359,3,6,0.5,1,5,6,12,3,2,10,16,31,SG,MIN
Emanuel Terry,22,6,0,46,8,14,0.5714285714285714,0,0,0,8,14,0.5714285714285714,0.5714285714285714,4,8,0.5,6,8,14,4,6,0,4,8,20,PF,TOT
Daniel Theis,26,66,2,908,146,266,0.5488721804511278,26,67,0.3880597014925373,120,199,0.6030150753768844,0.5977443609022557,56,76,0.7368421052631579,87,138,225,68,21,42,33,161,374,C,BOS
Isaiah Thomas,29,12,0,181,34,99,0.3434343434343434,12,43,0.27906976744186046,22,56,0.39285714285714285,0.40404040404040403,17,27,0.6296296296296297,5,8,13,23,5,1,18,17,97,SG,DEN
Khyri Thomas,22,26,0,195,22,69,0.3188405797101449,10,35,0.2857142857142857,12,34,0.35294117647058826,0.391304347826087,7,11,0.6363636363636364,4,16,20,8,7,5,4,22,61,SG,DET
Lance Thomas,30,46,17,783,78,197,0.39593908629441626,22,79,0.27848101265822783,56,118,0.4745762711864407,0.4517766497461929,27,36,0.75,21,96,117,27,17,7,24,83,205,PF,NYK
Klay Thompson,28,78,78,2652,655,1402,0.46718972895863053,241,599,0.4023372287145242,414,803,0.5155666251556662,0.5531383737517832,129,158,0.8164556962025317,37,262,299,186,84,47,115,157,1680,SG,GSW
Tristan Thompson,27,43,40,1198,201,380,0.5289473684210526,0,0,0,201,380,0.5289473684210526,0.5289473684210526,68,106,0.6415094339622641,173,265,438,86,28,16,59,89,470,C,CLE
Sindarius Thornwell,24,64,1,313,17,49,0.3469387755102041,3,15,0.2,14,34,0.4117647058823529,0.37755102040816324,25,34,0.7352941176470589,5,39,44,18,14,7,20,41,62,SG,LAC
Anthony Tolliver,33,65,0,1079,99,259,0.38223938223938225,81,215,0.3767441860465116,18,44,0.4090909090909091,0.5386100386100386,47,60,0.7833333333333333,15,162,177,46,17,21,36,91,326,PF,MIN
Karl-Anthony Towns,23,77,77,2545,681,1314,0.5182648401826484,142,355,0.4,539,959,0.5620437956204379,0.5722983257229832,376,450,0.8355555555555556,263,691,954,259,67,125,240,292,1880,C,MIN
Gary Trent,20,15,1,111,16,50,0.32,5,21,0.23809523809523808,11,29,0.3793103448275862,0.37,3,7,0.42857142857142855,1,10,11,5,1,2,4,4,40,SG,POR
Allonzo Trier,23,64,3,1459,232,518,0.44787644787644787,52,132,0.3939393939393939,180,386,0.46632124352331605,0.4980694980694981,179,223,0.8026905829596412,31,166,197,119,28,14,116,117,695,SG,NYK
PJ Tucker,33,82,82,2802,207,523,0.39579349904397704,146,387,0.3772609819121447,61,136,0.4485294117647059,0.5353728489483748,41,59,0.6949152542372882,121,358,479,96,132,39,63,252,601,PF,HOU
Evan Turner,30,73,2,1605,204,443,0.4604966139954853,11,52,0.21153846153846154,193,391,0.4936061381074169,0.4729119638826185,75,106,0.7075471698113207,37,291,328,283,33,18,114,110,494,PG,POR
Myles Turner,22,74,74,2119,380,780,0.48717948717948717,76,196,0.3877551020408163,304,584,0.5205479452054794,0.5358974358974359,148,201,0.736318407960199,101,430,531,115,60,199,100,195,984,C,IND
Ekpe Udoh,31,51,1,320,50,72,0.6944444444444444,0,0,0,50,72,0.6944444444444444,0.6944444444444444,19,30,0.6333333333333333,27,63,90,28,10,31,13,36,119,C,UTA
Tyler Ulis,23,1,0,1,0,0,0,0,0,0,0,0,0,0,0,0,0,0,0,0,0,0,0,0,0,0,PG,CHI
Jonas Valanciunas,26,98,54,2182,602,1076,0.5594795539033457,28,96,0.2916666666666667,574,980,0.5857142857142857,0.5724907063197026,294,370,0.7945945945945946,212,626,838,140,38,106,180,292,1526,C,TOT
Jarred Vanderbilt,19,17,0,69,9,19,0.47368421052631576,0,1,0,9,18,0.5,0.47368421052631576,6,10,0.6,7,16,23,3,6,1,8,8,24,PF,DEN
Fred VanVleet,24,64,28,1760,246,600,0.41,112,296,0.3783783783783784,134,304,0.4407894736842105,0.5033333333333333,97,115,0.8434782608695652,21,146,167,307,57,20,82,110,701,PG,TOR
Noah Vonleh,23,68,57,1722,207,440,0.47045454545454546,46,137,0.3357664233576642,161,303,0.5313531353135313,0.5227272727272727,111,156,0.7115384615384616,113,415,528,129,46,51,88,174,571,PF,NYK
Nikola Vucevic,28,80,80,2510,701,1354,0.517725258493353,84,231,0.36363636363636365,617,1123,0.5494211932324132,0.5487444608567208,179,227,0.788546255506608,224,736,960,307,81,89,159,157,1665,C,ORL
Dwyane Wade,37,72,2,1885,416,960,0.43333333333333335,86,261,0.32950191570881227,330,699,0.4721030042918455,0.478125,165,233,0.7081545064377682,69,216,285,301,59,38,166,118,1083,SG,MIA
Moritz Wagner,21,43,5,446,71,171,0.4152046783625731,22,77,0.2857142857142857,49,94,0.5212765957446809,0.47953216374269003,43,53,0.8113207547169812,17,68,85,24,11,13,39,57,207,C,LAL
Dion Waiters,27,44,28,1138,198,478,0.41422594142259417,109,289,0.3771626297577855,89,189,0.4708994708994709,0.5282426778242678,22,44,0.5,7,109,116,121,29,9,64,72,527,SG,MIA
Kemba Walker,28,82,82,2863,731,1684,0.4340855106888361,260,731,0.35567715458276333,471,953,0.49422875131164745,0.5112826603325415,380,450,0.8444444444444444,52,309,361,484,102,34,211,131,2102,PG,CHO
Lonnie Walker,20,17,0,118,16,46,0.34782608695652173,5,13,0.38461538461538464,11,33,0.3333333333333333,0.40217391304347827,8,10,0.8,0,17,17,9,7,3,4,7,45,SG,SAS
John Wall,28,32,32,1104,245,552,0.4438405797101449,51,169,0.30177514792899407,194,383,0.5065274151436031,0.490036231884058,122,175,0.6971428571428572,15,101,116,279,49,29,121,71,663,PG,WAS
Tyrone Wallace,24,62,0,628,92,217,0.423963133640553,4,19,0.21052631578947367,88,198,0.4444444444444444,0.43317972350230416,30,57,0.5263157894736842,20,81,101,42,21,7,36,83,218,PG,LAC
Taurean Waller-Prince,24,55,47,1552,262,594,0.44107744107744107,123,315,0.3904761904761905,139,279,0.4982078853046595,0.5446127946127947,95,116,0.8189655172413793,22,177,199,118,53,19,100,141,742,SF,ATL
Brad Wanamaker,29,36,0,343,50,105,0.47619047619047616,16,39,0.41025641025641024,34,66,0.5151515151515151,0.5523809523809524,24,28,0.8571428571428571,3,38,41,56,12,2,19,34,140,PG,BOS
TJ Warren,25,43,36,1360,297,611,0.486088379705401,77,180,0.42777777777777776,220,431,0.5104408352668214,0.5490998363338789,101,124,0.8145161290322581,31,143,174,64,51,29,52,119,772,SF,PHO
Julian Washburn,27,18,3,254,16,48,0.3333333333333333,5,24,0.20833333333333334,11,24,0.4583333333333333,0.3854166666666667,3,4,0.75,8,33,41,14,13,2,7,16,40,SF,MEM
Yuta Watanabe,24,15,0,174,15,51,0.29411764705882354,2,16,0.125,13,35,0.37142857142857144,0.3137254901960784,7,10,0.7,4,27,31,8,4,1,6,11,39,SF,MEM
Thomas Welsh,22,11,0,36,7,13,0.5384615384615384,3,7,0.42857142857142855,4,6,0.6666666666666666,0.6538461538461539,1,2,0.5,0,4,4,5,0,0,1,3,18,C,DEN
Russell Westbrook,30,73,73,2630,630,1473,0.42769857433808556,119,411,0.2895377128953771,511,1062,0.4811676082862524,0.4680923285811269,296,451,0.656319290465632,109,698,807,784,142,33,325,245,1675,PG,OKC
Derrick White,24,67,55,1728,260,543,0.47882136279926335,48,142,0.3380281690140845,212,401,0.5286783042394015,0.5230202578268877,95,123,0.7723577235772358,35,212,247,263,67,47,97,145,663,PG,SAS
Okaro White,26,3,0,6,0,2,0,0,2,0,0,0,0,0,0,0,0,1,1,2,0,0,0,0,0,0,PF,WAS
Hassan Whiteside,29,72,53,1674,388,680,0.5705882352941176,2,16,0.125,386,664,0.5813253012048193,0.5720588235294117,109,243,0.448559670781893,257,560,817,56,46,136,97,192,887,C,MIA
Andrew Wiggins,23,73,73,2543,498,1209,0.4119106699751861,118,348,0.3390804597701149,380,861,0.4413472706155633,0.46071133167907363,207,296,0.6993243243243243,83,269,352,184,70,48,138,153,1321,SF,MIN
Alan Williams,26,5,0,26,8,13,0.6153846153846154,0,1,0,8,12,0.6666666666666666,0.6153846153846154,2,4,0.5,4,15,19,3,1,0,1,2,18,PF,BRK
CJ Williams,28,15,0,128,17,35,0.4857142857142857,5,16,0.3125,12,19,0.631578947368421,0.5571428571428572,0,1,0,1,7,8,12,6,0,5,16,39,SG,MIN
Johnathan Williams,23,24,0,372,65,110,0.5909090909090909,0,2,0,65,108,0.6018518518518519,0.5909090909090909,27,48,0.5625,48,51,99,13,8,7,16,62,157,C,LAL
Kenrich Williams,24,46,29,1079,107,279,0.3835125448028674,52,156,0.3333333333333333,55,123,0.44715447154471544,0.4767025089605735,13,19,0.6842105263157895,55,164,219,83,45,19,36,95,279,SF,NOP
Lou Williams,32,75,1,1993,484,1138,0.4253075571177504,105,291,0.36082474226804123,379,847,0.4474616292798111,0.47144112478031636,425,485,0.8762886597938144,40,182,222,402,57,11,181,80,1498,SG,LAC
Marvin Williams,32,75,75,2133,275,652,0.4217791411042945,140,382,0.36649214659685864,135,270,0.5,0.5291411042944786,66,86,0.7674418604651163,76,331,407,92,71,61,47,156,756,PF,CHO
Robert Williams,21,32,2,283,36,51,0.7058823529411765,0,0,0,36,51,0.7058823529411765,0.7058823529411765,9,15,0.6,27,54,81,7,9,40,10,36,81,C,BOS
Troy Williams,24,21,0,312,44,98,0.4489795918367347,14,44,0.3181818181818182,30,54,0.5555555555555556,0.5204081632653061,9,15,0.6,12,47,59,11,10,8,9,37,111,SF,SAC
DJ Wilson,22,48,3,882,104,251,0.41434262948207173,46,127,0.36220472440944884,58,124,0.46774193548387094,0.5059760956175299,26,47,0.5531914893617021,45,177,222,52,18,20,32,85,280,PF,MIL
Justise Winslow,22,66,52,1959,324,749,0.4325767690253672,96,256,0.375,228,493,0.46247464503042596,0.49666221628838453,86,137,0.6277372262773723,63,292,355,282,72,19,142,177,830,SF,MIA
Christian Wood,23,42,4,502,122,234,0.5213675213675214,18,52,0.34615384615384615,104,182,0.5714285714285714,0.5598290598290598,82,112,0.7321428571428571,34,132,166,16,14,20,34,34,344,PF,TOT
Delon Wright,26,150,26,3398,484,1116,0.4336917562724014,100,336,0.2976190476190476,384,780,0.49230769230769234,0.478494623655914,238,300,0.7933333333333333,136,396,532,496,176,60,154,206,1306,PG,TOT
Guerschon Yabusele,23,41,1,251,35,77,0.45454545454545453,9,28,0.32142857142857145,26,49,0.5306122448979592,0.512987012987013,15,22,0.6818181818181818,23,30,53,15,8,7,15,32,94,PF,BOS
Nick Young,33,4,0,37,3,9,0.3333333333333333,3,8,0.375,0,1,0,0.5,0,0,0,0,1,1,2,0,1,2,4,9,SG,DEN
Thaddeus Young,30,81,81,2489,443,841,0.5267538644470868,51,146,0.3493150684931507,392,695,0.5640287769784172,0.5570749108204518,87,135,0.6444444444444445,192,331,523,204,123,36,123,194,1024,PF,IND
Trae Young,20,81,81,2503,525,1256,0.4179936305732484,156,482,0.3236514522821577,369,774,0.47674418604651164,0.48009554140127386,343,414,0.8285024154589372,64,237,301,653,72,15,308,140,1549,PG,ATL
Cody Zeller,26,49,47,1243,190,345,0.5507246376811594,6,22,0.2727272727272727,184,323,0.5696594427244582,0.5594202898550724,111,141,0.7872340425531915,110,223,333,102,38,41,62,164,497,C,CHO
Tyler Zeller,29,12,2,186,32,60,0.5333333333333333,0,2,0,32,58,0.5517241379310345,0.5333333333333333,28,36,0.7777777777777778,22,26,48,8,2,6,8,40,92,C,TOT
Ivica Zubac,21,118,74,2080,424,758,0.5593667546174143,0,0,0,424,758,0.5593667546174143,0.5593667546174143,202,252,0.8015873015873016,230,494,724,126,28,102,140,274,1050,C,TOT
Dario Saric,24,162,82,4046,608,1392,0.4367816091954023,236,646,0.3653250773993808,372,746,0.49865951742627346,0.521551724137931,264,300,0.88,252,662,914,254,90,18,194,364,1716,PF,TOT
Ante Zizic,22,59,25,1082,183,331,0.552870090634441,0,0,0,183,331,0.552870090634441,0.552870090634441,93,132,0.7045454545454546,108,212,320,53,13,22,61,113,459,C,CLE
